border_size=1
usage=map

Lh          , Lh          , Mon         , Mon         , Mon         , Mon         , Mon         , Mon         , Mon         , Mon         , Mon         , Mon         , Mon         , Mon         , Mon         , Mon         , Mon         , Mon         , Lh          , Lh          , Mon         , Mon         , Lh          , Lh          , Mon         , Mon^Fty     , Lh          , Lh          , Lh          , Lh          , Lh          , Lh          
Lh          , Mon^Min     , Mon         , Mon         , Mon         , Mon         , Mon^StrB    , Mon^StrB    , Mon^StrB    , Mon         , Mon         , Mon         , Mon         , Mon         , Mon         , Mon         , Mon         , Mon         , Lh          , Lh          , Lp          , Lh          , Lh          , Mon         , Lh          , Lp          , Lp          , Lh          , Lh          , Mon         , Lp          , Lh          
Lh          , Lh          , Mon         , Mon         , Mon         , Mon         , Mon^StrB    , 1 Mon^StrK  , Mon^StrB    , Mon         , Mon         , Mon         , Mon         , Mon         , Mon^Af      , Mon         , Mon         , Mon         , Mon         , Lp          , Mon^Min     , Mon         , Lh          , Lh          , Mon         , Lp          , Lp          , Lh          , Lh          , Lp          , Lp          , Lh          
Lh          , Mon         , Mon         , Mon         , Mon         , Mon         , Mon         , Mon^StrB    , Mon         , Mon         , Mon         , Mon^Fty     , Mon         , Mon         , Mon^Af      , Mon^Af      , Mon^Af      , Mon         , Mon         , Mon         , Mon         , Lh          , Lh          , Mon         , Lh          , Lp          , Lh          , Lh          , Lh          , Mon         , Lh          , Lh          
Lh          , Lh          , Mon         , Mon         , Mon         , Mon         , Mon         , Mon         , Mon         , Mon         , Mon         , Mon         , Mon         , Mon         , Mon         , Mon         , Mon         , Mon         , Mon         , Mon         , Mon         , Mon         , Mon         , Mon         , Mon         , Mon         , Mon         , Mon         , Lh          , Lh          , Lh          , Lh          
Mon         , Mon         , Mon         , Mon^Rea     , Mon         , Mon         , Mon         , Mon         , Mon         , Mon         , Mon         , Mon         , Mon         , Mon         , Mon         , Mon         , Mon         , Mon         , Mon         , Mon         , Mon         , Mon         , Mon         , Mon         , Mon         , Mon         , Mon^Af      , Mon^Af      , Mon         , Mon         , Mon         , Lh          
Mon         , Mon         , Mon         , Mon         , Mon         , Mon         , Mon         , Mon         , Mon         , Mon         , Lh          , Mon         , Lh          , Lh          , Lh          , Lh          , Mon         , Mon         , Mon         , Mon         , Mon         , Mon         , Mon         , Mon         , Mon         , Mon         , Mon         , Mon^Af      , Mon         , Mon         , Mon         , Mon         
Mon         , Mon         , Mon^Af      , Mon^Af      , Mon^Af      , Mon         , Mon         , Mon         , Mon         , Lh          , Lh          , Lh          , Lh          , Lh          , Lh          , Lh          , Mon         , Mon         , Mon         , Mon         , Mon         , Mon         , Mon         , Mon         , Lh          , Mon         , Lh          , Mon         , Lh          , Lh          , Lh          , Mon         
Mon         , Mon         , Mon         , Mon^Af      , Mon^Af      , Mon         , Mon         , Mon         , Mon         , Mon         , Lh          , Lh          , Lh          , Lh          , Lh          , Lh          , Mon         , Mon         , Mon         , Mon         , Mon         , Mon         , Lh          , Lh          , Lh          , Lh          , Lp          , Lh          , Lp          , Lp          , Lp          , Lh          
Mon         , Mon         , Mon         , Mon         , Mon         , Mon         , Mon         , Mon         , Mon         , Lh          , Lh          , Mon^Fre     , Lh          , Mon         , Mon         , Mon         , Mon         , Mon         , Mon         , Mon         , Mon         , Lh          , Lh          , Lh          , Lp          , Lp          , Lp          , Lp          , Lp          , Lh          , Lp          , Lp          
Mon         , Mon         , Mon         , Mon         , Mon^Fty     , Mon         , Mon         , Mon         , Mon         , Mon         , Mon         , Mon         , Mon         , Mon         , Mon         , Mon         , Mon         , Mon         , Mon         , Mon^Fty     , Mon^Af      , Mon         , Lh          , Lh          , Lh          , Lp          , Lp          , Lp          , Lp          , Lp          , Lh          , Lp          
Lh          , Mon         , Lh          , Mon         , Mon         , Mon         , Mon         , Mon         , Mon         , Mon         , Mon         , Mon         , Mon         , Mon         , Mon         , Mon         , Mon         , Mon         , Mon^Af      , Mon^Af      , Mon         , Mon         , Mon         , Lh          , Lh          , Lp          , Lp          , Lp          , Lp          , Lp          , Lp          , Lp          
Lp          , Lh          , Lh          , Lh          , Mon         , Mon         , Mon         , Mon         , Mon         , Mon         , Mon         , Mon         , Mon         , Mon         , Mon         , Mon         , Mon         , Mon         , Mon         , Mon^Af      , Mon         , Mon         , Mon         , Mon         , Mon^Dr      , Lh          , Lh          , Lh^Dr       , Lh          , Mon^Rfr     , Lh          , Lh          
Lp          , Lp          , Lh          , Lh          , Mon         , Mon         , Mon         , Mon         , Mon         , Mon         , Mon         , Mon         , Mon         , Mon         , Mon         , Mon         , Mon         , Mon         , Mon         , Mon         , Mon         , Mon         , Mon         , Mon         , Mon^Dr      , Mon         , Mon^Rge     , Lh          , Lh          , Lh          , Mon         , Mon^Dr      
Lp          , Mon^Fre     , Lh          , Mon         , Mon         , Mon         , Mon         , Mon         , Mon         , Mon         , Mon         , Mon^Fty     , Mon         , Mon         , Mon         , Mon         , Mon         , Mon         , Lh          , Mon         , Mon         , Mon         , Mon^Dr      , Mon         , Mon         , Mon         , Mon^Dr      , Mon^Dr      , Mon         , Mon^Dr      , Mon         , Mon         
Lp          , Lp          , Lh          , Lh          , Mon         , Mon         , Mon         , Mon         , Mon^Af      , Mon         , Mon         , Mon         , Mon         , Mon         , Lh          , Lh          , Lh          , Lh          , Mon         , Lh          , Lh          , Mon         , Lh          , Mon         , Mon         , Mon^Dr      , Mon         , Mon^Dr      , Mon^StrB    , Mon^Dr      , Mon         , Mon         
Lp          , Lp          , Lh          , Lh          , Lh          , Mon         , Mon         , Mon^Af      , Mon^Af      , Mon         , Mon         , Mon         , Mon         , Mon         , Mon         , Mon         , Lh          , Lh          , Lh          , Mon         , Mon         , Lh          , Lh          , Mon^Dr      , Mon^Rge     , Mon         , Mon         , Mon^StrB    , 2 Mon^StrK  , Mon^StrB    , Mon         , Mon^Dr      
Lp          , Lp          , Lp          , Lh          , Lh          , Lh          , Mon         , Mon         , Mon         , Mon         , Mon         , Mon         , Mon         , Mon         , Lh          , Lh          , Lh          , Lh          , Mon         , Lh^Dr       , Mon         , Mon^Dr      , Mon         , Mon         , Mon         , Mon^Dr      , Mon         , Mon^StrB    , Mon^Rba     , Mon^StrB    , Mon         , Mon         
Lp          , Lp          , Lp          , Lp          , Lh          , Lh          , Lh          , Lh          , Lh          , Mon         , Mon         , Mon         , Mon         , Mon         , Lh          , Lh          , Mon         , Mon         , Mon         , Mon         , Mon         , Mon         , Mon^Dr      , Mon         , Mon^Dr      , Mon         , Mon         , Mon         , Mon         , Mon         , Mon^Dr      , Mon         
Lp          , Lp          , Lp          , Lp          , Lh          , Lh          , Mon^Min     , Lh          , Lh          , Lh          , Lh          , Mon         , Mon         , Mon         , Mon         , Lh          , Mon         , Mon         , Mon         , Mon         , Mon         , Mon         , Mon         , Mon^Rfr     , Mon^Dr      , Mon         , Lh          , Mon^Dr      , Mon^Rre     , Mon         , Mon^Dr      , Mon         
Mon^Fty     , Lp          , Lp          , Lp          , Lp          , Lh          , Lh          , Lh          , Lh          , Lh          , Lh          , Lh          , Lh          , Mon         , Mon         , Mon         , Mon         , Mon^Fty     , Mon         , Mon         , Mon         , Mon         , Mon         , Mon         , Lh          , Lh          , Lh          , Mon         , Mon^Dr      , Mon         , Mon         , Mon         
Lp          , Lp          , Lp          , Lp          , Lp          , Lp          , Lp          , Lp          , Lh          , Lh          , Lh          , Lh          , Lh          , Lh          , Lh          , Mon         , Mon         , Mon         , Mon         , Mon         , Mon         , Mon         , Lh          , Lh          , Lh          , Lh          , Lh          , Mon         , Mon         , Mon         , Mon         , Mon^Dr      
