border_size=1
usage=map

Lh          , Mon         , Lp          , Mon         , Lh          , Lh          , Mon         , Mon         , Lh          , Mon         , Mon         , Mon         , Mon         , Mon         , Mon         , Mon         , Mon         , Mon         , Lh          , Lh          , Mon         , Lh          , Mon         , Mon         , Lh          , Mon         , Mon         , Mon         , Mon         , Mon         , Mon^Rfr     , Mon         
Lp          , Lp          , Lp          , Lp          , Mon^Af      , Lh          , Mon^Min     , Lh          , Mon         , Mon         , Mon         , Mon         , Mon         , Mon^Af      , Mon^Af      , Mon         , Mon         , Mon         , Lh          , Lh          , Lh          , Mon         , Lp          , Lh          , Lp          , Lh          , Mon^Af      , Mon^StrB    , Mon^StrB    , Mon^StrB    , 3 Mon^StrK  , Mon         
Lp          , Lp          , Lp          , Lp          , Lp          , Lp          , Lh          , Mon         , Mon^Af      , Mon         , Mon         , Mon         , Mon         , Mon         , Mon^Af      , Mon         , Mon         , Mon         , Mon         , Mon         , Mon^Rfr     , Lh          , Lh          , Lp          , Lh          , Lh          , Lh          , Mon^Rge     , Mon^StrB    , Mon^StrB    , Mon^StrB    , Mon         
Lp          , Lp          , Lp^Af       , Lh          , Mon         , Lh          , Mon         , Mon         , Mon         , Mon^Af      , Mon^Af      , Mon         , Mon         , Mon         , Mon         , Mon         , Mon         , Lh          , Lh          , Mon         , Mon         , Mon^Af      , Lh          , Lh          , Lh          , Lp          , Lp          , Lh          , Mon^StrB    , Mon^StrB    , Mon^StrB    , Mon         
Lh          , Mon^Min     , Lp          , Mon         , Ce          , Lh          , Mon         , Mon         , Mon         , Mon^Af      , Mon^Af      , Mon         , Mon         , Mon         , Mon         , Mon         , Mon         , Lh          , Lh          , Mon         , Lh          , Lh          , Lp          , Lp          , Mon         , Mon         , Mon         , Mon         , Lh          , Mon^StrB    , Mon^StrB    , Mon         
Lh          , Lp          , Lh          , Lh          , Mon         , Mon         , Mon         , Mon         , Mon         , Mon         , Mon         , Mon         , Mon         , Mon         , Mon         , Mon         , Mon         , Mon         , Mon         , Lh          , Mon^Rba     , Lh          , Lh          , Lh          , Mon         , Lh          , Lp          , Lh          , Lh          , Mon^StrB    , Mon^StrB    , Mon         
Lh          , Ce          , Mon^Gen     , Mon         , Mon^StrB    , Mon^Rea     , Mon         , Ce          , Mon         , Mon         , Mon         , Mon         , Mon         , Mon         , Mon         , Mon^Af      , Mon         , Mon         , Mon         , Lh          , Lh          , Lh          , Lh          , Mon^Af      , Mon         , Mon         , Lp          , Lp          , Lh          , Lh          , Mon         , Lh          
Mon         , Lh          , Mon         , Mon^StrB    , 2 Mon^StrK  , Mon^StrB    , Mon         , Mon         , Mon         , Mon         , Mon         , Mon         , Mon         , Mon         , Mon         , Mon^Af      , Mon         , Mon         , Mon         , Mon         , Mon         , Mon         , Lp          , Lh          , Mon         , Lh          , Mon^Rge     , Lh          , Lh          , Mon         , Mon         , Mon         
Mon         , Mon         , Mon         , Mon^StrB    , Mon^StrB    , Mon^StrB    , Mon         , Mon         , Mon         , Mon         , Mon         , Mon         , Mon         , Mon         , Mon         , Mon         , Mon         , Mon         , Mon         , Mon         , Mon         , Lh          , Lh          , Mon         , Mon         , Mon         , Mon         , Mon^Af      , Lh          , Lp          , Lh          , Mon         
Mon         , Ce          , Mon         , Mon^Rea     , Mon         , Mon         , Mon         , Ce          , Mon         , Mon         , Mon^Af      , Mon^Af      , Mon         , Mon         , Mon         , Mon         , Mon         , Mon         , Mon         , Mon         , Mon         , Mon         , Mon         , Mon         , Lh          , Mon         , Lh          , Mon         , Lh          , Lp          , Lh          , Mon         
Mon         , Mon         , Mon         , Mon         , Ce          , Mon         , Mon         , Mon         , Mon         , Mon^Af      , Mon         , Mon         , Mon^Gen     , Mon         , Mon         , Mon         , Mon         , Mon         , Mon         , Mon         , Mon         , Mon         , Mon         , Mon         , Mon         , Lh          , Mon         , Mon         , Lh          , Lp          , Lp          , Lh          
Mon         , Mon         , Mon         , Mon         , Mon         , Mon         , Mon         , Mon         , Mon         , Mon         , Mon         , Mon         , Mon         , Mon         , Mon         , Mon         , Mon         , Mon         , Mon         , Mon         , Mon^Af      , Mon         , Mon         , Mon         , Mon         , Mon         , Mon         , Mon         , Mon         , Lh          , Lh          , Lh          
Mon         , Mon         , Mon         , Mon^Af      , Mon^Af      , Mon         , Mon         , Mon         , Mon         , Mon         , Mon         , Mon         , Mon         , Mon         , Mon         , Mon         , Mon         , Mon         , Lh          , Mon         , Mon         , Mon^Af      , Mon^Af      , Mon         , Mon         , Mon         , Mon         , Mon         , Mon         , Mon         , Mon         , Mon         
Mon         , Mon         , Mon         , Mon^Af      , Mon         , Mon^Af      , Mon         , Mon         , Mon         , Mon         , Mon         , Mon         , Mon^Af      , Mon         , Mon         , Mon         , Lh          , Lh          , Lp          , Lh          , Lh          , Mon         , Mon         , Mon         , Mon         , Mon         , Mon         , Mon         , Mon         , Mon         , Mon         , Mon         
Mon         , Mon         , Mon         , Mon         , Mon         , Mon         , Mon         , Mon         , Mon         , Mon         , Mon         , Mon^Af      , Mon         , Mon         , Mon         , Mon         , Lh          , Lp          , Mon^Min     , Lp          , Lh          , Lh          , Lh          , Mon         , Mon         , Mon         , Mon         , Mon         , Mon         , Mon         , Mon         , Mon         
Mon         , Mon         , Lh          , Lh          , Lh          , Mon         , Mon         , Mon         , Mon         , Mon         , Mon         , Mon^Af      , Mon         , Mon         , Mon         , Mon         , Mon         , Lh          , Lp          , Lp          , Lp          , Lp          , Lp          , Lh          , Mon         , Mon         , Mon         , Mon         , Mon         , Mon         , Mon         , Mon         
Lh          , Lh          , Lp          , Lp          , Lp          , Lh          , Mon^Xxx     , Mon         , Mon         , Mon         , Mon         , Mon         , Mon         , Mon         , Mon         , Mon         , Mon         , Lh          , Lh          , Lp          , Lh          , Mon^Gen     , Lh          , Lh          , Mon         , Mon         , Mon         , Mon         , Mon^Xxx     , Mon^Af      , Mon^Af      , Mon         
Mon         , Lh          , Lh          , Lp          , Lh          , Lh          , Lh          , Mon         , Mon         , Mon         , Mon         , Mon         , Mon         , Mon         , Mon         , Mon         , Mon         , Mon         , Mon         , Lh          , Mon         , Mon         , Mon         , Mon         , Mon         , Mon         , Mon         , Mon         , Mon         , Mon         , Mon^Af      , Mon         
Mon         , Lh          , Mon         , Lh          , Mon^Af      , Mon^Af      , Mon         , Mon         , Mon         , Mon         , Mon         , Mon         , Mon         , Mon         , Mon         , Mon         , Mon         , Mon         , Mon         , Mon         , Mon         , Mon         , Mon         , Mon         , Mon         , Mon         , Mon         , Mon         , Mon^StrB    , Mon         , Mon         , Mon         
Mon         , Mon         , Mon         , Mon^Af      , Mon         , Mon         , Mon         , Mon         , Lh          , Lh          , Lh          , Mon         , Mon         , Mon         , Mon         , Mon         , Mon^Af      , Mon         , Mon         , Mon         , Mon         , Mon         , Mon         , Mon         , Mon         , Mon^Af      , Mon         , Mon^StrB    , 1 Mon^StrK  , Mon^StrB    , Mon         , Mon         
Mon         , Mon         , Mon         , Mon^Af      , Mon         , Mon         , Lh          , Lh          , Mon         , Mon         , Lp          , Lh          , Lh          , Mon         , Mon         , Mon^Af      , Mon^Af      , Mon         , Mon         , Mon         , Lh          , Mon         , Mon         , Mon         , Mon         , Mon         , Mon         , Mon^StrB    , Mon^StrB    , Mon^StrB    , Mon         , Mon         
Mon         , Mon         , Mon         , Mon         , Mon^Fty     , Lh          , Mon         , Lp          , Lp          , Lp          , Lp          , Lp          , Lh          , Lh          , Mon^Xxx     , Mon         , Mon         , Mon         , Mon         , Lh          , Lh          , Mon         , Mon         , Mon         , Mon^Fty     , Mon         , Mon         , Mon         , Mon         , Mon         , Mon         , Mon         
Mon         , Mon         , Mon         , Lh          , Lh          , Lp          , Lp          , Lp          , Lh          , Mon^Min     , Lh          , Lp          , Lp          , Lp          , Lp          , Lp          , Lp          , Lh          , Lh          , Lh          , Lh          , Mon         , Mon         , Mon         , Mon         , Mon         , Mon         , Mon         , Mon         , Mon         , Mon         , Mon         
