border_size=1
usage=map

Lp          , Lh          , Lp          , Lp          , Lp          , Mon         , Mon         , Mon         , Lp          , Mon         , Lp          , Lh          , Lp          , Mon         , Lp          , Lh          , Lh          , Lp          , Lp          , Lp          , Lp          , Mon         , Mon         , Mon         , Mon         , Mon         , Mon         , Mon         , Mon         , Mon         , Mon         , Mon         , Mon         , Mon         , Mon         , Mon         , Mon         , Mon         , Mon         , Mon         , Mon         , Mon         , Mon         , Mon         , Mon         , Mon         
Lp          , Lp          , Lp          , Lp          , Mon^Min     , Lp          , Lp          , Lp          , Lp          , Lp          , Lp          , Lp          , Lp          , Lp          , Lp          , Lh          , Lh          , Lh          , Lh          , Lh          , Lp          , Mon         , Mon         , Mon         , Mon         , Mon         , Mon^Af      , Mon^Af      , Mon^Af      , Mon         , Mon         , Mon         , Mon         , Mon         , Mon         , Mon^Af      , Mon^Af      , Mon^Af      , Mon         , Mon^Rge     , Mon^StrB    , Mon^StrB    , Mon^StrB    , Mon^StrB    , Mon^StrB    , Mon         
Lp          , Lp          , Lp          , Lp          , Lp          , Lp          , Lp          , Lp          , Mon^Af      , Lp          , Lh          , Lh          , Lh          , Lh          , Lh          , Mon         , Lp          , Lp          , Lh          , Lh          , Lh          , Mon         , Mon         , Mon         , Mon         , Mon^Af      , Mon^Fty     , Mon^Af      , Mon^Af      , Mon         , Mon         , Mon         , Mon         , Mon         , Mon         , Mon         , Mon^Rba     , Mon         , Mon         , Mon^StrB    , Mon^StrB    , Mon^StrB    , Mon^StrB    , 3 Mon^StrK  , Mon^StrB    , Mon         
Lp          , Lp          , Lp          , Lp          , Lp          , Mon^Af      , Lp          , Lp          , Lp          , Mon^Af      , Lp          , Lh          , Lp          , Lh          , Mon         , Lp          , Lp          , Lp          , Lh          , Mon^Min     , Lh          , Mon         , Mon         , Mon         , Mon         , Mon^Af      , Mon^Af      , Mon^Af      , Mon         , Mon         , Mon         , Mon         , Mon         , Mon         , Mon         , Mon         , Mon         , Mon         , Mon         , Mon^StrB    , Mon^StrB    , Mon^StrB    , Mon^StrB    , Mon^StrB    , Mon^StrB    , Mon         
Lp          , Lp          , Lp          , Lh          , Lp          , Lh          , Lp          , Lp          , Mon^Min     , Lh          , Lp          , Lp          , Mon         , Lp          , Lh          , Lp          , Mon         , Lp          , Lh          , Lh          , Lh          , Mon         , Mon         , Mon         , Mon         , Mon         , Mon         , Mon         , Mon         , Mon         , Mon         , Mon         , Mon         , Mon         , Mon         , Mon         , Lh          , Mon         , Mon         , Mon^StrB    , Mon^StrB    , Mon^StrB    , Mon^StrB    , Mon^StrB    , Mon^StrB    , Mon         
Lp          , Lp          , Lp          , Lh          , Lh          , Lh          , Lh          , Lp          , Lp          , Lp          , Mon^Af      , Lh          , Mon         , Mon         , Lh          , Lp          , Lh          , Lh          , Mon         , Mon^Af      , Mon^Af      , Mon^Af      , Mon         , Mon         , Mon         , Mon         , Mon         , Mon         , Mon         , Mon         , Mon         , Mon         , Mon         , Mon         , Mon         , Lh          , Lh          , Lh          , Lh          , Mon         , Mon         , Mon^Rge     , Mon^Af      , Mon^StrB    , Mon^StrB    , Mon         
Lp          , Lh          , Mon^Min     , Lh          , Lp          , Lp          , Lp          , Lp          , Lp          , Lh          , Mon^Af      , Lp          , Lp          , Lh          , Lh          , Lh          , Lh          , Mon         , Lh          , Lh          , Mon         , Lh          , Mon         , Mon         , Mon         , Mon         , Mon         , Mon         , Mon         , Mon         , Mon         , Mon         , Mon         , Lh          , Lh          , Lh          , Lh          , Mon^Rfr     , Lh          , Mon         , Mon         , Mon^Af      , Mon         , Mon^Af      , Mon         , Mon         
Mon         , Lp          , Lp          , Lp          , Lp          , Lp          , Lp          , Lh          , Lh          , Lh          , Lh          , Lp          , Mon         , Lh          , Lh          , Mon         , Lh          , Lh          , Lh          , Mon         , Mon         , Mon         , Mon         , Mon         , Mon         , Mon         , Mon         , Mon         , Lh          , Lh          , Lh          , Lh          , Lh          , Lh          , Lp          , Lh          , Lh          , Lp          , Lh          , Mon         , Mon         , Mon^Af      , Mon^Af      , Mon^Af      , Mon         , Mon         
Mon         , Lh          , Lp          , Mon^Af      , Lp          , Lp          , Lh          , Lh          , Lp          , Lh          , Mon         , Lh          , Mon         , Mon         , Lh          , Mon         , Lh          , Lh          , Mon         , Mon         , Mon         , Mon         , Mon         , Mon         , Mon         , Mon         , Mon         , Mon         , Lh          , Lh          , Lh          , Lh          , Mon^Rre     , Lp          , Lp          , Lp          , Lp          , Lh          , Lh          , Mon         , Mon         , Mon         , Mon         , Mon         , Mon         , Mon         
Lp          , Lp          , Lh          , Lh          , Mon         , Lh          , Lp          , Lp          , Lh          , Mon         , Lh          , Mon         , Lh          , Lh          , Lh          , Lh          , Mon         , Mon         , Mon         , Mon         , Mon         , Mon         , Mon         , Mon         , Mon         , Mon         , Mon         , Mon         , Lh          , Lh          , Lh          , Lp          , Lh          , Lh          , Lh          , Lp          , Lh          , Lh          , Lh          , Mon         , Mon         , Mon         , Mon^Rba     , Mon         , Mon         , Mon         
Mon         , Lh          , Lh          , Lh          , Lh          , Mon         , Lh          , Lh          , Lh          , Lh          , Mon         , Lh          , Lh          , Lh          , Mon         , Mon         , Mon         , Mon         , Mon         , Mon         , Mon         , Mon         , Mon         , Mon         , Mon         , Mon         , Mon         , Mon         , Mon         , Lh          , Mon         , Lh          , Lh          , Lp          , Lp          , Lh          , Lh          , Lh          , Lh          , Lh          , Mon         , Mon         , Mon         , Mon         , Mon         , Mon         
Mon         , Mon         , Mon         , Lh          , Lh          , Mon^Min     , Lh          , Lh          , Mon         , Lh          , Mon         , Mon         , Mon         , Mon         , Mon         , Mon         , Mon^Fty     , Mon^Af      , Mon         , Mon^Af      , Mon^Af      , Mon         , Mon         , Mon         , Mon         , Mon         , Mon         , Mon         , Mon         , Mon         , Mon         , Lh          , Lh          , Lh          , Lh          , Lh          , Lh          , Mon         , Mon         , Mon         , Mon         , Mon         , Mon         , Mon         , Mon         , Mon         
Mon         , Mon         , Mon^Af      , Mon         , Mon         , Mon         , Mon         , Mon         , Mon         , Mon         , Mon         , Mon         , Mon         , Mon         , Mon         , Mon         , Mon^Af      , Mon^Af      , Mon^Af      , Mon         , Mon         , Mon         , Mon         , Mon         , Mon         , Mon         , Mon         , Mon         , Mon         , Mon         , Mon         , Mon         , Mon         , Lh          , Mon         , Mon         , Mon         , Mon         , Mon         , Mon         , Mon^Af      , Mon^Af      , Mon^Af      , Mon         , Mon         , Mon         
Mon         , Mon         , Mon         , Mon^Af      , Mon^Af      , Mon^Af      , Mon         , Mon         , Mon         , Mon         , Mon         , Mon         , Mon         , Mon         , Mon         , Mon         , Mon         , Mon         , Mon         , Mon         , Mon         , Mon         , Mon         , Mon         , Mon         , Mon         , Mon         , Mon         , Mon         , Mon         , Mon^Af      , Mon^Af      , Mon         , Mon         , Mon         , Mon         , Mon         , Mon         , Mon         , Mon         , Mon^Af      , Mon^Af      , Mon         , Mon^Af      , Mon         , Mon         
Mon         , Mon         , Mon         , Mon         , Mon         , Mon         , Mon         , Mon         , Mon         , Mon         , Mon         , Mon         , Mon         , Mon         , Mon         , Mon         , Mon         , Mon         , Mon         , Mon         , Mon         , Mon         , Mon^Xxx     , Mon         , Mon         , Mon         , Mon         , Mon         , Mon         , Mon         , Mon^Af      , Mon^Af      , Mon^Af      , Mon         , Mon         , Mon         , Mon         , Mon         , Mon         , Mon         , Mon         , Mon         , Mon         , Mon^Af      , Mon         , Mon         
Mon         , Mon         , Mon^StrB    , Mon         , Mon^StrB    , Mon         , Mon         , Mon         , Mon         , Mon         , Mon         , Mon         , Mon         , Mon         , Lh          , Mon         , Lh          , Mon         , Mon         , Mon         , Mon         , Mon         , Mon         , Mon         , Mon         , Mon         , Mon         , Mon         , Mon         , Mon         , Mon^Af      , Mon         , Mon         , Mon         , Mon         , Mon^Gen     , Mon         , Mon         , Mon         , Mon         , Mon         , Mon         , Mon         , Mon         , Mon         , Mon         
Mon         , Mon^StrB    , Mon^StrB    , Mon^StrB    , Mon^StrB    , Mon^StrB    , Mon^Fty     , Mon         , Mon         , Mon         , Mon         , Lh          , Lh          , Lh          , Lh          , Lh          , Lh          , Lh          , Lh          , Mon         , Mon         , Mon         , Mon         , Mon         , Mon         , Mon         , Mon         , Mon         , Mon         , Mon         , Mon         , Mon         , Mon         , Mon         , Mon         , Mon         , Mon         , Mon         , Mon         , Mon         , Mon         , Mon         , Mon         , Mon         , Mon         , Mon         
Mon         , Mon^StrB    , Mon^StrB    , 2 Mon^StrK  , Mon^StrB    , Mon^StrB    , Mon         , Mon         , Lh          , Lh          , Lh          , Lh          , Lp          , Lp          , Lp          , Lp          , Lp          , Lh          , Lh          , Mon         , Mon         , Mon         , Mon         , Mon         , Mon         , Mon         , Mon         , Mon         , Lh          , Lh          , Lh          , Lh          , Lh          , Lh          , Lh          , Mon         , Mon         , Mon         , Mon         , Mon         , Mon         , Mon         , Mon         , Mon         , Mon         , Mon         
Mon         , Mon^StrB    , Mon^StrB    , Mon^StrB    , Mon^StrB    , Mon^StrB    , Mon         , Mon         , Mon         , Lh          , Lh          , Lp          , Lp          , Lp          , Lp          , Lp          , Lh          , Lh          , Lh          , Mon         , Mon         , Mon         , Mon         , Mon         , Mon         , Mon         , Lh          , Lh          , Lh          , Lh          , Lh          , Lh          , Lh          , Lh          , Lh          , Lh          , Lh          , Lh          , Lh          , Lh          , Lh          , Lh          , Lh          , Lh          , Lh          , Mon         
Mon         , Mon         , Mon         , Mon^Xxx     , Mon         , Mon         , Mon         , Mon         , Lh          , Lh          , Lh          , Lp          , Lh          , Lp          , Lh          , Lh          , Lh          , Lh          , Mon         , Mon         , Mon         , Mon         , Mon         , Mon         , Mon^Af      , Lh          , Lh          , Mon^Xxx     , Lh          , Lh          , Lh          , Lh          , Lh          , Lh          , Lh          , Lh          , Lh          , Mon^Rea     , Lh          , Lh          , Lh          , Lh          , Lh          , Lh          , Lh          , Lh          
Mon         , Mon         , Mon^Af      , Mon^Af      , Mon         , Mon         , Mon         , Mon         , Mon         , Lh          , Lh          , Lh          , Lh          , Lh          , Lh          , Mon         , Mon         , Mon         , Mon         , Mon         , Mon         , Mon         , Mon         , Mon         , Mon^Af      , Lh          , Lh          , Lh          , Lp          , Lp          , Lp          , Lp          , Lp          , Lp          , Lp          , Lh          , Lh          , Lh          , Lh          , Lh          , Lh          , Lh          , Lh          , Lh          , Lh          , Lh          
Mon^Af      , Mon^Af      , Mon^Fre     , Mon^Af      , Mon         , Mon         , Mon         , Mon         , Mon         , Mon         , Mon         , Mon^Fre     , Mon         , Mon         , Mon         , Mon         , Mon         , Mon         , Mon         , Mon         , Mon         , Mon         , Mon         , Mon         , Mon^Af      , Lh          , Lh          , Lh          , Lh          , Lp          , Lp          , Lp          , Lp          , Lp          , Lp          , Lp          , Lp          , Lp          , Lp          , Lp          , Lp          , Lp          , Lp          , Lp          , Lp          , Lp          
Mon         , Mon^Af      , Mon         , Mon^Af      , Mon         , Mon         , Mon         , Mon         , Mon         , Mon         , Mon         , Mon         , Mon         , Mon         , Mon         , Mon         , Mon         , Mon         , Mon         , Mon         , Mon         , Mon         , Mon         , Mon         , Mon         , Lh          , Lh          , Lh          , Lh          , Lp          , Lh          , Lp          , Lp          , Lp          , Lp          , Lp          , Lp          , Lp          , Mon^Min     , Lp          , Lp          , Lp          , Lp          , Lp          , Lp          , Lp          
Mon         , Mon^Af      , Mon^Af      , Mon^Af      , Mon         , Mon         , Mon         , Mon         , Mon         , Mon         , Mon         , Mon         , Mon         , Mon         , Mon         , Mon         , Mon         , Mon         , Mon         , Mon         , Mon         , Mon         , Mon         , Mon         , Mon         , Mon         , Lh          , Lh          , Lh          , Lh          , Lh          , Lh          , Lp          , Lp          , Lp          , Lp          , Lp          , Lp          , Lp          , Lp          , Lp          , Lp          , Lp          , Lp          , Strs^Af     , Strs        
Mon         , Mon         , Mon         , Mon         , Mon         , Mon         , Mon         , Mon         , Mon         , Mon         , Mon         , Mon         , Mon         , Mon         , Mon         , Mon         , Mon         , Mon         , Mon         , Mon         , Mon         , Mon^Gen     , Mon         , Mon         , Mon         , Mon         , Mon         , Lh          , Lh          , Lh          , Lh          , Lh          , Lh          , Mon^Min     , Lh          , Lp          , Lp          , Lp          , Lp          , Lp          , Lp          , Lp          , Strs^Af     , Strs^Af     , Strs^Af     , Strs^Af     
Mon         , Mon         , Mon         , Mon         , Lh          , Lh          , Lh          , Lh          , Lh          , Mon         , Mon         , Mon^Af      , Mon^Af      , Mon         , Mon         , Mon         , Mon         , Mon         , Mon         , Mon         , Mon         , Mon         , Mon         , Mon         , Mon         , Mon         , Mon         , Lh          , Lh          , Lh          , Lh          , Lh          , Lh          , Lh          , Lh          , Lh          , Lh          , Lh          , Lh          , Lp          , Strs^Af     , Strs^Af     , Strs        , Strs^Af     , Strs        , Strs        
Mon         , Mon         , Lh          , Mon^Fty     , Lh          , Lh          , Lh          , Lh          , Lh          , Mon         , Mon         , Mon^Af      , Mon^Af      , Mon^Af      , Mon         , Mon         , Mon         , Mon         , Mon         , Mon         , Mon         , Mon         , Mon         , Mon         , Mon         , Mon         , Mon         , Mon         , Mon         , Lh          , Lh          , Lh          , Lh          , Lh          , Lh          , Lh          , Lh          , Lh          , Strs        , Strs^Af     , Strs        , Strs        , Strs        , Strs        , Strs^Af     , Strs        
Lh          , Lh          , Lh          , Lh          , Lp          , Lp          , Lp          , Lh          , Lh          , Lh          , Lh          , Mon         , Mon         , Mon^Af      , Mon         , Mon         , Mon         , Mon         , Mon         , Mon         , Mon         , Mon         , Mon         , Mon         , Mon         , Mon         , Mon         , Mon         , Mon         , Mon^Gen     , Mon         , Lh          , Mon         , Lh          , Lh          , Lh          , Lh          , Lh          , Strs        , Strs^Af     , Strs        , Pln         , Strs        , Strs        , Strs        , Strs        
Lh          , Lh          , Lp          , Lh          , Lp          , Lp          , Lp          , Lp          , Lp          , Lh          , Lh          , Lh          , Mon^Fty     , Mon         , Mon         , Mon         , Mon         , Mon         , Mon         , Mon         , Mon         , Mon         , Mon         , Mon         , Mon^Af      , Mon^Af      , Mon^Af      , Mon         , Mon         , Mon         , Mon         , Mon         , Mon         , Mon         , Mon         , Mon         , Mon         , Lh          , Strs        , Strs        , Strs        , Strs        , Strs        , Strs        , Strs        , Strs        
Lh          , Lh          , Lp          , Lp          , Lp          , Lp          , Lp          , Lp          , Lp          , Lh          , Lh          , Lh          , Lh          , Mon         , Mon         , Mon         , Mon         , Mon         , Mon         , Mon         , Mon         , Mon         , Mon         , Mon^Af      , Mon^Af      , Mon^Af      , Mon^Af      , Mon         , Mon         , Mon         , Mon         , Mon         , Mon^StrB    , Mon         , Mon         , Mon         , Mon         , Mon         , Strs        , Strs        , Strs        , Strs        , Strs        , Strs^Af     , Strs        , StrC        
Lh          , Lh          , Lh          , Lp          , Lp          , Lp          , Lp          , Lp          , Lp          , Lh          , Lh          , Lh          , Mon         , Mon         , Mon         , Mon         , Mon         , Mon         , Mon         , Mon         , Mon         , Mon         , Mon         , Mon         , Mon         , Mon^Fty     , Mon         , Mon         , Mon         , Mon         , Mon         , Mon^StrB    , Mon^StrB    , Mon^StrB    , Mon^Fty     , Mon         , Mon         , Mon         , Strs        , Strs^Af     , Strs        , Strs        , Strs        , Strs        , StrC        , Strs        
Lh          , Lh          , Lh          , Lp          , Lp          , Lp          , Lp          , Lp          , Lh          , Lh          , Lh          , Lh          , Mon         , Mon         , Mon         , Mon         , Mon         , Mon         , Mon         , Mon         , Mon         , Mon         , Mon         , Mon         , Mon         , Mon         , Mon         , Mon         , Mon         , Mon         , Mon         , Mon^StrB    , 1 Mon^StrK  , Mon^StrB    , Mon         , Mon         , Mon         , Mon         , Strs        , Strs        , Strs        , Pln         , Strs        , Strs        , StrC        , StrC        
Lh          , Lh          , Lh          , Lh          , Lh          , Lp          , Lh          , Lh          , Lh          , Lh          , Mon         , Mon         , Mon         , Mon         , Mon         , Mon         , Mon         , Mon         , Mon         , Mon         , Mon         , Mon         , Mon         , Mon         , Mon         , Mon         , Mon         , Mon         , Mon         , Mon         , Mon^Xxx     , Mon^StrB    , Mon^StrB    , Mon^StrB    , Mon         , Mon         , Mon         , Mon         , Mon         , Strs        , Strs        , Strs        , Strs        , Strs        , StrC        , StrC        
Lh          , Lh          , Lh          , Lh          , Lh          , Lh          , Lh          , Lh          , Lh          , Lh          , Mon         , Mon         , Mon         , Mon         , Mon         , Mon         , Mon         , Mon^Gen     , Mon         , Mon         , Mon         , Mon         , Mon         , Mon         , Mon         , Mon         , Mon         , Mon         , Mon         , Mon         , Mon         , Mon^StrB    , Mon^StrB    , Mon^StrB    , Mon         , Mon         , Mon         , Mon         , Mon         , Strs        , Strs^Af     , Strs^Af     , Strs        , StrC        , StrC        , StrC        
Lh          , Lh          , Lh          , Lh          , Lh          , Lh          , Lh          , Lh          , Lh          , Lh          , Mon         , Mon         , Mon         , Mon         , Mon         , Mon         , Mon         , Mon         , Mon         , Mon         , Mon         , Mon         , Mon         , Mon         , Mon         , Mon         , Mon         , Mon         , Mon         , Mon         , Mon         , Mon         , Mon         , Mon         , Mon         , Mon         , Mon         , Mon         , Mon         , Strs        , Strs^Af     , Strs        , StrC        , StrC        , StrC        , StrC        
