border_size=1
usage=map

Strs        , Strs        , Strs        , Strs        , Strs        , Strs        , Strs        , StrC        , StrC        , StrC        , StrC        , StrC        , StrC        , StrC        , StrC        , StrC        , StrC        , StrC        , StrC        , StrC        , StrC        , Strs        , StrC        , StrC        , Strs        , Strs        , StrC        , StrC        , StrC        , StrC        
Strs        , Strs        , Pln         , Strs        , Strs        , Strs        , Strs        , Strs        , Strs        , Strs        , Strs        , Strs        , Strs        , Strs        , Strs        , Strs        , Strs        , Strs        , Strs        , Strs        , Strs        , Strs        , Strs        , Strs        , Strs        , Strs        , Strs        , Strs        , Strs        , Strs        
Strs        , Strs        , Strs        , Strs        , Strs        , Strs        , Mon^Af      , Strs        , Mon         , Mon^Fty     , Mon         , Mon         , Mon         , Mon^Fty     , Mon         , Strs        , Mon^StrB    , Strs        , Mon         , Strs        , Mon^Fty     , Strs        , Lh          , Lp          , Lp          , Strs        , Strs        , Pln         , Strs        , Strs        
Strs^Af     , Strs        , Strs        , Strs        , Mon         , Mon^Fty     , Mon^Af      , Mon         , Mon         , Mon         , Mon         , Mon         , Mon         , Mon         , Mon         , Mon^StrB    , Mon^StrB    , Mon^StrB    , Mon         , Mon         , Mon         , Mon         , Mon         , Lh          , Lp          , Strs        , Strs        , Strs        , Strs        , Strs        
Strs^Af     , Strs^Af     , Strs        , Strs        , Ce          , Mon         , Strs        , Mon^Af      , Mon         , Mon         , Mon         , Mon         , Mon         , Mon         , Mon^Fty     , Mon^StrB    , 3 Mon^StrK  , Mon^StrB    , Mon         , Mon         , Mon         , Mon         , Mon         , Lh          , Mon^Fty     , Lp          , Strs        , Strs        , Strs        , Strs        
Strs^Af     , Strs        , Strs        , Strs        , Mon         , Ce          , Strs        , Mon         , Mon         , Mon^Fty     , Mon         , Mon         , Mon         , Mon         , Mon         , Mon^StrB    , Mon^StrB    , Mon^StrB    , Mon         , Mon         , Mon^Fty     , Mon         , Mon         , Mon         , Lh          , Lp          , Lp          , Strs        , Strs^Af     , Strs        
Strs        , Strs        , Strs        , Strs        , Mon         , Mon         , Strs        , Strs        , Strs        , Mon         , Mon         , Mon         , Mon         , Mon         , Mon         , Mon^StrB    , Mon^StrB    , Mon^StrB    , Mon         , Mon         , Mon         , Mon         , Mon         , Mon         , Mon         , Lh          , Lh          , Strs        , Strs^Af     , Strs        
StrC        , Strs        , Pln         , Strs        , Mon         , Mon         , Strs        , Pln         , Strs        , Strs        , Ce          , Ce          , Ce          , Mon^Fty     , Strs        , Mon         , Strs        , Mon         , Mon         , Mon         , Mon         , Mon         , Mon         , Mon         , Mon         , Mon         , Mon^Fty     , Strs        , Strs^Af     , Strs        
StrC        , Strs        , Strs        , Strs        , Mon         , Mon         , Strs        , Strs        , Strs^Af     , Strs        , Mon         , Mon^Af      , Mon         , Strs        , Strs        , Strs        , Strs^Af     , Strs        , Strs^Af     , Strs        , Strs        , Mon         , Mon^Fty     , Mon         , Mon         , Mon         , Strs        , Strs        , Strs^Af     , Strs        
StrC        , Strs        , Strs        , Strs        , Mon         , Mon         , Strs        , Strs^Af     , Strs^Af     , Strs        , Mon^Af      , Mon^Af      , Mon         , Strs        , Strs        , Strs^Af     , Strs        , Strs^Af     , Strs        , Strs^Af     , Strs        , Ce          , Ce          , Mon         , Strs        , Strs        , Strs        , Strs        , Strs^Af     , Strs        
Strs^Af     , Strs        , Strs        , Strs        , Mon         , Mon         , Strs        , Strs        , Strs        , Strs        , Mon         , Mon         , Mon         , Strs        , Strs        , Strs        , Strs        , Strs        , Strs        , Strs        , Strs        , Mon         , Lh          , Strs        , Strs        , Strs        , Strs        , Strs        , Strs^Af     , Strs        
Strs^Af     , Strs        , Strs        , Strs        , Mon         , Mon         , Strs        , StrC        , StrC        , Strs        , Mon         , Mon         , Mon         , Strs        , Strs        , Strs        , Strs^Af     , Pln         , Strs        , Strs        , Strs        , Lh          , Lh          , Strs        , Strs        , Pln         , Strs        , Strs        , Strs^Af     , Strs        
Strs        , Strs^Af     , Strs        , Strs        , Mon         , Mon         , Strs        , Strs        , Strs        , Strs        , Mon         , Mon         , Mon         , Strs        , Strs        , Strs^Af     , Strs        , Strs^Af     , Strs^Af     , Strs^Af     , Strs        , Mon         , Mon         , Strs        , Strs        , Strs        , Strs        , Strs        , Strs^Af     , Strs        
Strs        , Strs        , Strs        , Strs        , Mon^Af      , Mon^Af      , Mon^Af      , Strs        , Mon^Fty     , Strs        , Mon         , Mon         , Mon         , Strs        , Strs        , Strs        , Mon         , Strs        , Strs        , Strs        , Strs        , Lh          , Mon^Fty     , Strs        , Strs        , StrC        , StrC        , Strs        , Strs^Af     , Strs        
Lp          , Strs        , Lh          , Mon         , Mon^Af      , Mon         , Mon^StrB    , Mon         , Mon         , Mon         , Mon         , Mon         , Mon         , Mon         , Mon         , Mon         , Lh          , Lh          , Mon^Fty     , Strs        , Strs        , Mon         , Lh          , Strs        , Strs        , StrC        , Strs        , Strs        , Strs^Af     , Strs        
Lp          , Lh          , Lh          , Mon         , Mon^StrB    , Mon^StrB    , Mon^StrB    , Mon^StrB    , Mon^StrB    , Mon         , Mon^Af      , Mon^Af      , Mon         , Lh          , Lh          , Lh          , Lh          , Lh          , Lh          , Lh          , Lh          , Lh          , Mon         , Strs        , Strs        , Strs        , Strs        , Strs        , Strs        , Strs        
Lp          , Lh          , Mon^Fty     , Mon         , Mon^StrB    , Mon^StrB    , 2 Mon^StrK  , Mon^StrB    , Mon^StrB    , Mon^Af      , Mon         , Mon         , Mon         , Lh          , Lh          , Lp          , Lp          , Lp          , Lp          , Lh          , Lp          , Lh          , Mon         , Strs        , Strs        , Pln         , Strs        , Strs        , Strs        , Strs        
Lp          , Lh          , Lh          , Mon         , Mon^StrB    , Mon^StrB    , Mon^StrB    , Mon^StrB    , Mon^StrB    , Mon         , Mon         , Mon         , Mon         , Mon^Fty     , Lh          , Lp          , Lp          , Lp          , Lp          , Lp          , Lp          , Lh          , Mon         , Lh          , Strs        , Strs        , Strs^Af     , Strs^Af     , Strs^Af     , Strs        
Lp          , Lp          , Lp          , Lh          , Lh          , Mon^StrB    , Mon^StrB    , Mon^StrB    , Mon         , Mon         , Mon         , Mon         , Mon         , Mon         , Lh          , Lh          , Lh          , Lp          , Lp          , Lp          , Lh          , Lh          , Lh          , Mon         , Mon         , Strs        , Strs        , Strs        , Strs        , Strs        
Lp          , Lp          , Lp          , Mon^Af      , Lh          , Lh          , Mon         , Mon         , Mon^Af      , Mon         , Mon         , Mon         , Mon         , Mon         , Mon         , Lh          , Lh          , Lh          , Lh          , Lp          , Lh          , Lh          , Mon         , Mon         , Mon         , Mon         , Mon         , Strs        , Strs        , Strs        
Lp          , Lp          , Lp          , Lp          , Lp          , Lh          , Lh          , Mon         , Mon         , Mon^Af      , Mon^Af      , Mon         , Mon^Af      , Mon         , Mon         , Mon         , Mon         , Mon         , Mon         , Lh          , Mon         , Mon         , Mon^Af      , Mon^Af      , Mon^Af      , Mon^Af      , Mon         , Mon^Fty     , Mon^StrB    , Lh          
Lp          , Lp          , Lp          , Lp          , Lp          , Lp          , Mon^Af      , Lh          , Lh          , Mon         , Mon         , Mon         , Mon         , Mon         , Mon         , Mon         , Mon         , Mon         , Mon         , Mon         , Mon         , Mon         , Mon         , Mon         , Mon         , Mon         , Mon^StrB    , Mon^StrB    , Mon^StrB    , Lh          
Lp          , Lp          , Lp          , Lp          , Mon^Fty     , Lp          , Lp          , Lp          , Lp          , Mon         , Mon         , Mon         , Mon         , Mon^Af      , Mon         , Mon         , Mon         , Mon         , Mon         , Mon         , Mon         , Mon         , Mon         , Mon         , Mon         , Mon^StrB    , Mon^StrB    , Mon^StrB    , Mon^StrB    , Lh          
Lp          , Lp          , Lp          , Lp          , Lp          , Lp          , Lp          , Lp          , Lp          , Lh          , Lh          , Mon         , Lh          , Mon         , Mon         , Mon         , Mon^Fty     , Mon         , Mon         , Mon         , Mon         , Mon         , Mon         , Mon         , Mon         , Mon^StrB    , Mon^StrB    , Mon^StrB    , 1 Mon^StrK  , Lh          
Lp          , Lp          , Lp          , Lp          , Lp          , Lp          , Lp          , Lp          , Lp          , Lp          , Lp          , Lh          , Lp          , Lh          , Lh          , Mon         , Mon         , Mon         , Mon^Af      , Mon^Af      , Mon^Af      , Mon^Af      , Mon^Af      , Mon         , Lh          , Lh          , Lh          , Lh          , Lh          , Lh          
