border_size=1
usage=map

Mon^Min     , Lp          , Lp          , Lp          , Lp          , Lp          , Lh          , Lh          , Lh          , Lh          , Lh          , Lp          , Lp          , Lp          , Mon^Min     , Lp          , Strs        , Strs        , Strs        , Strs        , Strs        , Strs        , Mon         , Mon         , Mon         , Mon         , Mon         , Mon         , Mon         , Mon         , Mon         , Mon         , Mon^Af      , Mon^Af      , Mon^Af      , Mon         , Mon^Rre     , Mon         , Mon^StrB    , Mon         
Lp          , Lh          , Lh          , Mon^Rea     , Lh          , Lh          , Mon^StrB    , Mon^StrB    , Mon^StrB    , Mon         , Mon         , Lh          , Lh          , Lh          , Lh          , Lh          , Strs        , Strs        , Strs        , Strs        , Mon^Af      , Mon^Rge     , Mon         , Mon         , Mon         , Mon^Af      , Mon^Af      , Mon         , Mon         , Mon^Rba     , Mon         , Mon         , Mon         , Mon         , Mon^Rre     , Mon^Fty     , Mon^StrB    , Mon^StrB    , Mon^StrB    , Mon         
Lh          , Lh          , Lh          , Lh          , Mon         , Mon         , Mon^StrB    , Mon^StrB    , Mon^StrB    , Mon         , Mon         , Mon         , Mon         , Mon         , Mon         , Mon         , Strs        , Strs        , Ce          , Mon^Af      , Mon         , Mon         , Mon         , Mon         , Mon         , Mon^Af      , Mon         , Mon         , Mon         , Mon         , Mon         , Mon         , Mon         , Mon^Rba     , Mon^StrB    , Mon^StrB    , Mon^StrB    , Mon^StrB    , Mon^StrB    , Mon         
Lh          , Mon^Fty     , Mon^StrB    , Mon^StrB    , Mon^StrB    , Mon         , Mon^StrB    , 2 Mon^StrK  , Mon^StrB    , Mon         , Mon         , Mon         , Mon^Af      , Mon         , Mon         , Mon^Rea     , Ce          , Mon^Fty     , Ce          , Mon         , Mon         , Mon         , Mon^Rge     , Mon         , Mon         , Mon         , Mon         , Mon         , Lh          , Mon         , Lh          , Mon         , Mon         , Mon^Rfr     , Mon^StrB    , Mon^StrB    , Mon^StrB    , Mon^StrB    , Mon^StrB    , Mon         
Mon         , Mon         , Mon^StrB    , Mon^StrB    , Mon^StrB    , Mon         , Mon^StrB    , Mon^StrB    , Mon^StrB    , Mon         , Mon         , Mon         , Mon^Af      , Mon         , Mon         , Mon         , Ce          , Mon         , Ce          , Mon         , Strs        , Strs        , Lp          , Lh          , Mon         , Mon         , Mon         , Lh          , Lp          , Lh          , Lp          , Lh          , Mon         , Mon^Fty     , Mon^StrB    , Mon^StrB    , Mon^StrB    , Mon^StrB    , Mon^StrB    , Mon         
Mon^Af      , Mon         , Mon^StrB    , 1 Mon^StrK  , Mon^StrB    , Mon         , Mon         , Mon^StrB    , Mon^Af      , Mon         , Mon         , Mon         , Mon         , Mon         , Mon         , Mon         , Ce          , Mon^Fre     , Strs        , Strs        , Strs        , Strs        , Lp          , Lh          , Mon^Af      , Mon         , Mon         , Lh          , Lh          , Lh          , Lh          , Lh          , Mon         , Mon^Rba     , Mon^StrB    , Mon^StrB    , Mon^StrB    , 3 Mon^StrK  , Mon^StrB    , Mon         
Mon^Af      , Mon         , Mon^StrB    , Mon^StrB    , Mon^StrB    , Mon         , Mon         , Mon^Af      , Mon^Af      , Mon         , Mon         , Mon         , Mon         , Mon         , Mon         , Mon^Fty     , Strs        , Strs        , Strs        , Strs        , Mon         , Lh          , Lh          , Lh          , Mon^Af      , Mon         , Mon         , Mon         , Mon         , Mon         , Mon         , Mon         , Mon         , Mon^Rfr     , Mon^StrB    , Mon^StrB    , Mon^StrB    , Mon^StrB    , Mon^StrB    , Mon         
Mon         , Mon         , Mon         , Mon^StrB    , Mon^Rea     , Mon         , Mon         , Mon         , Mon         , Mon         , Mon         , Mon^Fre     , Mon         , Mon         , Mon         , Mon         , Mon^Fty     , Strs        , Mon^Fre     , Ce          , Mon         , Mon         , Mon         , Mon^Af      , Mon^Af      , Mon         , Mon         , Mon         , Mon         , Mon         , Mon         , Mon^Af      , Mon         , Mon^Rba     , Mon^StrB    , Mon^StrB    , Mon^StrB    , Mon^StrB    , Mon^StrB    , Mon         
Mon         , Mon         , Mon         , Mon         , Mon         , Mon         , Mon         , Mon         , Mon         , Mon         , Mon         , Mon         , Mon         , Mon         , Mon         , Mon         , Mon         , Ce          , Mon         , Ce          , Mon         , Mon         , Mon         , Mon         , Mon         , Mon         , Mon         , Mon         , Mon         , Mon         , Mon         , Mon^Af      , Mon         , Mon^Rfr     , Mon^Rre     , Mon^StrB    , Mon^StrB    , Mon^StrB    , Mon^StrB    , Mon         
Lh          , Mon         , Mon         , Mon^Af      , Mon^Af      , Mon^Af      , Mon         , Mon         , Mon         , Mon         , Mon         , Mon         , Mon         , Mon         , Mon         , Mon         , Mon         , Ce          , Mon^Fty     , Ce          , Strs        , Strs        , Strs        , Mon         , Mon^Rba     , Mon         , Mon         , Mon         , Mon         , Mon         , Mon         , Mon         , Mon         , Mon         , Mon         , Mon^Rba     , Mon^Rfr     , Mon^StrB    , Mon^StrB    , Mon         
Lp          , Mon^Rea     , Lh          , Mon         , Lh          , Mon         , Mon^Fre     , Mon         , Mon         , Mon         , Mon         , Mon         , Mon^Fty     , Mon         , Mon         , Mon         , Mon^Rea     , Ce          , Strs^Af     , Strs^Af     , Strs        , Strs        , Strs        , Strs        , Strs        , Mon^Af      , Mon         , Mon         , Mon^Fty     , Lh          , Lh          , Lh          , Lh          , Lh          , Lh          , Mon         , Mon         , Mon         , Mon         , Mon         
Lh          , Lp          , Lp          , Lh          , Lp          , Lh          , Lh          , Mon         , Mon         , Mon         , Lh          , Lh          , Lh          , Lh          , Lh          , Lh          , Lh          , Strs        , Strs        , Strs        , Strs        , Pln         , Strs        , Strs^Af     , Strs        , Strs        , Strs        , Lh          , Lp          , Lp          , Lp          , Lp          , Lp          , Lp          , Lp          , Lh          , Lh          , Mon         , Lh          , Mon         
Lh          , Lh          , Lh          , Lh          , Lp          , Lh          , Lh          , Mon         , Mon         , Mon         , Lh          , Lh          , Lp          , Lp          , Lp          , Lp          , Lp          , Strs        , Strs        , Strs        , Strs        , Strs        , Strs        , Strs        , Strs        , Strs        , Strs        , Lh          , Lp          , Lp          , Lp          , Lp          , Lp          , Lp          , Lh          , Lh          , Mon^Min     , Lh          , Lh          , Mon         
Lp          , Lp          , Lp          , Lp          , Lp          , Lp          , Lh          , Mon         , Mon         , Mon         , Lh          , Lp          , Lp          , Lh          , Lp          , Lp          , Lh          , Strs        , Strs        , Strs^Af     , Strs        , Strs        , Strs        , Strs        , Strs        , Strs        , Strs^Af     , Strs        , Strs        , Lh          , Lh          , Mon^Min     , Lh          , Lh          , Lh          , Lh          , Lp          , Lp          , Lp          , Lh          
Lp          , Lp          , Lp          , Lp          , Lp          , Lh          , Lh          , Mon         , Mon         , Mon         , Mon         , Lh          , Lh          , Lp          , Lp          , Lp          , Lh          , Strs        , Strs        , Strs        , Strs        , Strs        , Strs        , Strs        , Strs        , Strs        , Strs        , Strs        , Strs        , Strs        , Strs        , Lh          , Lp          , Lh          , Lp          , Lh          , Lp          , Lp          , Lp          , Lp          
Mon^Min     , Lp          , Lp          , Lh          , Lh          , Lp          , Lh          , Lp          , Mon         , Mon         , Mon         , Lp          , Lh          , Lh          , Lh          , Lh          , Lh          , Strs        , Strs        , Strs        , Strs        , Strs        , Strs        , Strs        , Strs        , Strs        , Strs        , Strs        , Strs        , Strs        , Strs        , Strs        , Strs        , Lp          , Lp          , Lp          , Lp          , Lp          , Mon^Min     , Lp          
