border_size=1
usage=map

Mon^Min     , Lh          , Lh          , Mon         , Mon         , Mon         , Mon         , Mon         , Mon         , Mon         , Mon         , Mon         , Mon         , Mon         , Lh          , Mon         , Lh          , Mon         , Mon         , Mon         , Lh          , Lp          , Mon^Min     
Lp          , Lp          , Lp          , Lh          , Mon^Rea     , Mon         , Mon         , Mon         , Mon^StrB    , Mon         , Mon         , Mon         , Mon^Xxx     , Lh          , Lp          , Lp          , Lh          , Mon         , Mon         , Mon^Rea     , Lh          , Lp          , Lp          
Lp          , Lp          , Lp          , Lh          , Mon         , Mon         , Mon^StrB    , Mon^StrB    , 2 Mon^StrK  , Mon^StrB    , Mon^StrB    , Mon         , Mon         , Lh          , Lh          , Lp          , Mon^Fty     , Mon         , Mon         , Mon         , Lh          , Lp          , Lp          
Lp          , Lp          , Lp          , Lh          , Lh          , Mon^StrB    , Mon^StrB    , Mon^StrB    , Mon^StrB    , Mon^StrB    , Mon^StrB    , Mon^StrB    , Mon         , Mon         , Mon         , Lh          , Mon         , Mon         , Strs        , Strs        , Strs        , Lh          , Lh          
Strs        , Lh          , Strs        , Lp          , Lh          , Mon         , Mon         , Mon^StrB    , Mon^StrB    , Mon^StrB    , Mon         , Mon         , Mon         , Mon         , Mon         , Mon         , Strs        , Strs        , Strs        , Strs        , Strs^Af     , Strs        , Strs        
Strs        , Strs        , Strs^Af     , Strs        , Strs        , Mon         , Mon^Fty     , Mon^Af      , Mon^Af      , Mon         , Mon         , Mon         , Mon         , Mon         , Mon^Gen     , Strs        , Strs        , Strs        , Pln         , Strs        , Strs        , Strs        , Strs        
Strs        , Strs        , Strs        , Strs        , Strs        , Strs        , Strs        , Mon^Af      , Mon         , Mon         , Mon         , Mon         , Mon         , Mon         , Strs        , Strs        , Strs        , Strs        , Strs        , Strs        , Strs        , Strs        , Strs        
Strs        , Strs        , Strs        , Pln         , Strs        , Strs        , Strs        , Strs        , Strs        , Mon         , Mon         , Mon         , Lh          , Strs        , Strs        , Strs^Af     , Strs        , Strs        , Strs        , Strs        , Strs^Af     , Strs        , Strs        
Strs        , Strs        , Strs        , Strs        , Strs        , Strs^Af     , Strs        , Strs        , Strs        , Mon         , Mon         , Mon^Xxx     , Lp          , Strs        , Strs        , Strs        , Strs        , Strs        , Pln         , Strs        , Strs        , Strs        , Strs        
Strs        , Strs^Af     , Strs^Af     , Strs        , Strs        , Strs^Af     , Strs        , Strs        , Strs        , Mon         , Mon         , Lh          , Lh          , Lp          , Lh          , Strs        , Strs        , Strs        , Strs        , Strs        , Strs        , Strs        , Strs        
Strs        , Strs^Af     , Strs        , Strs        , Strs        , Strs^Af     , Strs        , Strs        , Lh          , Mon         , Mon         , Mon         , Mon         , Lh          , Mon         , Mon^Af      , Mon^Af      , Strs        , Strs        , Strs        , Strs^Af     , Strs        , Strs        
Strs        , Strs        , Strs        , Strs        , Strs^Af     , Strs^Af     , Strs        , Lp          , Lh          , Mon^Rea     , Mon         , Mon         , Mon         , Mon         , Mon         , Mon         , Mon         , Mon^Af      , Mon^Xxx     , Strs        , Strs        , Strs        , Mon         
Strs        , Strs        , Strs        , Strs^Af     , Strs        , Strs        , Strs        , Mon^Min     , Lp          , Lh          , Mon^Af      , Mon         , Mon         , Mon         , Mon         , Mon         , Mon         , Mon         , Mon^StrB    , Mon         , Mon         , Mon^Fty     , Mon         
Strs        , Strs        , Strs        , Strs        , Pln         , Strs        , Strs        , Lp          , Lh          , Mon         , Mon         , Mon         , Mon         , Mon         , Mon         , Mon         , Mon         , Mon^StrB    , Mon^StrB    , Mon^StrB    , Mon^StrB    , Mon         , Mon         
Strs        , Strs        , Strs        , Strs        , Strs        , Strs        , Strs        , Strs        , Mon^Xxx     , Mon         , Mon         , Mon         , Mon         , Mon         , Mon^Fty     , Mon         , Mon         , Mon^StrB    , Mon^StrB    , 1 Mon^StrK  , Mon^StrB    , Mon         , Mon         
Strs        , Strs        , Strs        , Strs^Af     , Strs        , Strs        , Strs        , Strs        , Mon         , Mon         , Mon         , Mon         , Lh          , Lh          , Lp          , Lh          , Lh          , Mon         , Mon         , Mon^StrB    , Mon         , Mon^Gen     , Mon         
Strs        , Strs^Af     , Strs^Af     , Strs^Af     , Strs^Af     , Strs        , Strs        , Mon         , Mon         , Mon         , Mon         , Mon         , Lh          , Lp          , Mon^Min     , Lp          , Lp          , Lh          , Mon         , Mon         , Mon         , Mon         , Mon         
