border_size=1
usage=map

Mon         , Mon         , Mon         , Mon         , Mon         , Mon         , Mon         , Mon         , Mon         , Mon         , Mon         , Mon         , Mon         , Mon         , Mon         , Mon         , Mon         , Mon         , Mon         , Mon         , Mon         , Mon         , Mon         , Mon         , Mon         , Mon         , Mon         , Mon         , Mon         , Mon         , Mon         , Mon         , Mon         , Mon         , Mon         , Mon         , Mon         
Mon         , Mon         , Mon         , Mon         , Mon^StrB    , Mon^StrB    , Mon^StrB    , Mon^Rea     , Re          , Re          , Gs          , Mon         , Mon         , Mon^Fty     , Mon         , Mon         , Mon^StrB    , Mon         , Mon^Fty     , Mon         , Mon         , Mon         , Lh          , Mon         , Lh          , Lh          , Lh          , Lh          , Mon^Min     , Lh          , Mon         , Mon         , Mon         , Mon         , Mon         , Mon         , Mon         
Mon         , Mon         , Mon^Xxx     , Mon         , Mon^StrB    , Mon^StrB    , Mon^StrB    , Gs          , Gs^Fds      , Gs^Fds      , Gs^Fds      , Gs          , Re          , Mon         , Mon^StrB    , Mon^StrB    , Mon^StrB    , Mon         , Mon         , Mon         , Mon         , Lh          , Lp          , Lh          , Lp          , Lh          , Lp          , Lh          , Lp          , Lh          , Lh          , Mon         , Mon         , Mon         , Mon         , Mon         , Mon         
Mon         , Mon         , Mon         , Mon         , Mon^StrB    , 3 Mon^StrK  , Mon^StrB    , Re          , Gs^Fds      , Gs^Fds      , Gs^Fds      , Gs^Fds      , Gs^Fds      , Re          , Mon^StrB    , 1 Mon^StrK  , Mon^StrB    , Mon         , Mon         , Mon         , Lh          , Lh          , Lp          , Lp          , Mon^Min     , Lh          , Lp          , Lp          , Lp          , Lp          , Lh          , Mon         , Mon         , Mon         , Mon^Fty     , Mon         , Mon         
Mon         , Mon         , Mon         , Mon         , Mon^StrB    , Mon^StrB    , Mon^StrB    , Re          , Gs          , Gs^Fds      , Gs^Fds      , Gs^Fds      , Gs          , Re          , Mon^StrB    , Mon^StrB    , Mon         , Mon         , Mon         , Lh          , Lp          , Lh          , Lp          , Lp          , Lp          , Lp          , Lh          , Lp          , Lp          , Lh          , Mon         , Mon         , Mon         , Mon         , Mon         , Mon         , Mon         
Mon         , Mon         , Mon^Fty     , Mon         , Mon         , Mon^StrB    , Mon         , Mon^Xxx     , Mon         , Re          , Re          , Gs^Fds      , Re          , Mon         , Mon         , Mon         , Mon         , Mon^Rea     , Mon         , Lh          , Lh          , Lp          , Lh          , Lp          , Lh          , Lp          , Lh          , Lp          , Lh          , Lh          , Mon         , Mon         , Mon         , Mon         , Mon         , Mon         , Mon         
Mon         , Mon         , Mon         , Mon         , Mon         , Mon         , Mon         , Mon         , Mon^Fre     , Mon         , Mon         , Re          , Mon         , Mon^Fty     , Mon         , Mon         , Mon         , Mon         , Mon         , Mon         , Mon         , Lh          , Mon         , Lh          , Mon         , Lh          , Lh          , Lh          , Mon         , Mon         , Mon         , Mon         , Mon         , Mon         , Mon         , Mon         , Mon         
Mon         , Mon         , Mon         , Mon         , Mon         , Mon         , Mon         , Mon         , Mon         , Mon         , Mon         , Mon         , Mon         , Mon         , Mon         , Mon         , Mon^Af      , Mon         , Mon         , Mon         , Mon         , Mon         , Mon         , Mon         , Mon         , Mon         , Mon         , Mon         , Mon         , Mon         , Mon^Fre     , Mon         , Mon         , Mon         , Mon         , Mon         , Mon         
Mon         , Mon         , Mon         , Mon         , Gs          , Gs          , Re          , Mon         , Mon         , Mon         , Mon         , Mon         , Mon         , Mon^Af      , Mon^Af      , Mon^Af      , Mon^Af      , Mon         , Mon         , Mon         , Mon         , Mon^Fty     , Mon         , Mon         , Mon         , Mon         , Mon         , Mon         , Mon         , Mon         , Mon         , Mon         , Re          , Re          , Re          , Mon         , Mon         
Mon         , Mon         , Mon         , Mon         , Re          , Gs          , Re          , Mon         , Mon         , Mon         , Mon         , Mon         , Mon         , Mon         , Mon         , Mon^Af      , Mon^Af      , Mon         , Mon         , Mon         , Mon         , Mon         , Mon         , Mon         , Mon         , Mon         , Mon         , Mon         , Mon         , Mon         , Mon         , Mon         , Re          , Re          , Re          , Mon         , Mon         
Mon         , Mon         , Mon         , Mon         , Mon         , Re          , Re          , Mon         , Mon         , Mon         , Mon         , Mon         , Mon         , Mon         , Mon         , Mon         , Mon         , Mon         , Mon         , Mon         , Mon         , Mon         , Re          , Re          , Mon         , Mon         , Mon         , Mon         , Mon         , Mon         , Mon         , Mon         , Mon         , Mon         , Mon         , Mon         , Mon         
Mon         , Mon^Af      , Mon         , Mon         , Mon         , Mon         , Mon         , Mon         , Mon         , Mon         , Mon         , Mon         , Mon         , Mon         , Mon^Rea     , Mon         , Mon         , Mon         , Mon         , Mon         , Mon         , Mon         , Mon         , Re          , Mon         , Mon         , Mon         , Mon         , Mon         , Mon         , Mon^Af      , Mon^Af      , Mon^Af      , Mon         , Mon         , Mon         , Mon         
Mon         , Mon^Af      , Mon^Af      , Mon^Fre     , Mon         , Mon         , Mon         , Mon         , Mon         , Mon         , Re          , Mon         , Mon         , Mon         , Mon         , Mon         , Mon         , Mon         , Mon         , Mon         , Mon         , Mon         , Mon         , Mon         , Mon         , Mon         , Mon         , Mon         , Mon^Af      , Mon^Af      , Mon^Af      , Mon^Af      , Mon         , Mon         , Mon         , Mon         , Mon         
Mon         , Mon         , Mon^Af      , Mon^Af      , Mon         , Mon         , Mon         , Mon         , Re          , Re          , Gs          , Re          , Mon         , Mon         , Mon         , Mon         , Mon         , Mon         , Mon         , Mon         , Mon         , Mon         , Mon         , Mon         , Mon         , Mon         , Mon^Rba     , Mon         , Mon         , Mon^Af      , Mon^Af      , Mon^Af      , Mon         , Mon         , Mon         , Mon         , Mon         
Mon         , Mon         , Mon         , Mon         , Mon         , Mon         , Mon         , Mon         , Re          , Re          , Mon         , Re          , Mon         , Mon         , Mon         , Mon         , Mon         , Mon         , Mon         , Mon         , Mon         , Mon         , Mon         , Mon         , Mon         , Mon         , Mon         , Mon         , Mon         , Mon         , Mon         , Mon         , Mon         , Mon         , Mon         , Mon         , Mon         
Mon         , Mon         , Mon         , Mon         , Lh          , Mon         , Mon         , Mon         , Mon         , Mon         , Mon         , Mon         , Mon         , Mon         , Mon         , Mon         , Mon         , Mon^Rre     , Mon         , Mon         , Mon         , Mon         , Mon         , Mon         , Mon         , Mon         , Mon         , Mon         , Mon         , Mon         , Mon         , Mon         , Mon         , Mon         , Mon         , Mon         , Mon         
Lh          , Lh          , Lh          , Lh          , Lh          , Lh          , Mon         , Mon         , Mon         , Mon         , Mon         , Mon         , Mon         , Mon         , Mon         , Mon         , Mon         , Mon         , Mon^Af      , Mon         , Mon         , Mon         , Mon         , Mon         , Re          , Re          , Mon         , Mon         , Mon         , Mon         , Mon         , Mon         , Mon         , Mon^Rge     , Mon         , Mon         , Mon         
Lh          , Lh          , Lp          , Lh          , Lh          , Lh          , Lh          , Mon         , Mon         , Mon         , Mon^Fty     , Mon         , Mon         , Mon         , Mon         , Mon         , Mon^Af      , Mon^Af      , Mon^Af      , Mon         , Mon         , Mon         , Mon         , Re          , Mon         , Mon         , Mon         , Mon         , Mon         , Mon         , Mon         , Mon         , Mon         , Mon         , Mon         , Mon         , Mon         
Lp          , Lp          , Lp          , Lp          , Lp          , Mon^Rea     , Lh          , Mon         , Mon         , Mon         , Mon         , Mon         , Mon         , Mon         , Mon         , Mon^Af      , Mon^Af      , Mon^Af      , Mon^Af      , Mon         , Mon         , Mon         , Mon         , Re          , Mon         , Mon         , Mon         , Mon         , Mon^StrB    , Mon         , Mon^StrB    , Mon         , Mon         , Mon         , Mon         , Mon         , Mon         
Lp          , Lp          , Lp          , Lp          , Lp          , Lh          , Lh          , Lh          , Mon         , Mon         , Mon         , Mon         , Mon         , Mon         , Mon         , Mon         , Mon         , Mon^Af      , Mon         , Mon         , Mon         , Mon         , Mon         , Mon         , Mon         , Mon         , Mon^StrB    , Mon^StrB    , Mon^StrB    , Mon^StrB    , Mon^StrB    , Mon^StrB    , Mon^StrB    , Mon         , Mon         , Mon         , Mon         
Lp          , Lp          , Lp          , Lp          , Lp          , Lp          , Lh          , Lh          , Lh          , Mon         , Mon         , Mon         , Re          , Mon         , Mon         , Mon         , Mon         , Mon         , Mon         , Mon         , Mon         , Mon         , Mon         , Mon         , Mon         , Mon         , Mon^StrB    , Mon^StrB    , 4 Mon^StrK  , Mon^StrB    , 2 Mon^StrK  , Mon^StrB    , Mon^StrB    , Mon         , Mon         , Mon         , Mon         
Lh          , Lp          , Lh          , Lp          , Lh          , Lp          , Lh          , Lh          , Lh          , Mon         , Re          , Re          , Gs          , Re          , Mon         , Mon         , Mon         , Mon         , Mon         , Mon         , Mon         , Mon         , Mon         , Mon^Rba     , Mon         , Mon         , Mon^StrB    , Mon^StrB    , Mon^StrB    , Mon^StrB    , Mon^StrB    , Mon^StrB    , Mon^StrB    , Mon^Rge     , Mon         , Mon         , Mon         
Lh          , Lh          , Lh          , Lh          , Mon^Min     , Lh          , Lh          , Lh          , Mon^Af      , Mon         , Mon         , Re          , Re          , Mon         , Mon         , Mon         , Mon         , Mon         , Mon         , Mon         , Mon         , Mon         , Mon         , Mon         , Mon         , Mon         , Mon         , Mon^StrB    , Mon^StrB    , Mon^StrB    , Mon^StrB    , Mon^StrB    , Mon         , Mon         , Mon         , Mon         , Mon         
Lh          , Lh          , Mon         , Lh          , Mon         , Lh          , Mon         , Mon^Af      , Mon^Af      , Mon^Af      , Mon         , Mon         , Mon         , Mon         , Mon         , Mon         , Mon^Rre     , Mon         , Mon         , Mon         , Mon         , Mon         , Re          , Mon         , Mon         , Mon         , Mon         , Mon         , Mon         , Mon         , Mon         , Mon         , Mon         , Mon         , Mon         , Mon         , Mon         
Mon         , Mon         , Mon         , Mon         , Mon         , Mon         , Mon         , Mon         , Mon         , Mon         , Mon         , Mon         , Mon         , Mon         , Mon         , Mon         , Mon         , Mon         , Mon         , Mon         , Mon         , Mon         , Mon         , Re          , Re          , Mon         , Mon         , Mon         , Mon         , Mon         , Mon         , Mon         , Mon         , Mon         , Mon^Rre     , Mon         , Mon         
Mon         , Mon         , Mon         , Mon         , Mon         , Mon         , Mon         , Mon         , Mon         , Mon         , Mon         , Mon         , Mon         , Mon         , Mon         , Mon         , Mon         , Mon         , Mon         , Mon         , Mon         , Mon         , Mon         , Re          , Re          , Re          , Re          , Mon         , Mon         , Mon         , Mon         , Mon         , Mon         , Mon         , Mon         , Mon         , Mon         
