border_size=1
usage=map

Lh          , Lp          , Mon^StrB    , Lp          , Mon^StrB    , Strs        , Mon^StrB    , Strs        , Strs        , Strs        , Mon         , Mon         , Mon         , Mon         , Mon         , Mon         , Mon         , Strs        , Strs        , Strs        , Strs        , Strs        , Mon         , Strs        , Strs        , Strs        , Strs        , Strs        , Strs        , Strs        , Strs        , Strs        , Strs        , Strs        
Lh          , Mon^StrB    , Mon^StrB    , Mon^StrB    , Mon^StrB    , Mon^StrB    , Mon^StrB    , Mon^Rfr     , Mon         , Ce          , Mon         , Mon         , Mon^Rba     , Mon         , Mon         , Mon         , Strs        , Mon         , Strs        , Mon         , Mon^Rre     , Mon         , Mon         , Mon         , Mon         , Lp          , Lp          , Lp          , Mon^Rge     , Strs        , Strs        , Strs        , Strs        , Strs        
Lh          , Mon^StrB    , 3 Mon^StrK  , Mon^StrB    , 2 Mon^StrK  , Mon^StrB    , Mon^StrB    , Mon         , Lh          , Lh          , Lh          , Mon         , Mon         , Mon         , Mon         , Mon         , Mon         , Mon         , Mon         , Mon         , Strs        , Mon         , Mon         , Mon         , Mon         , Mon         , Mon         , Lp          , Mon         , Strs        , Strs        , Strs^Af     , Strs^Af     , Strs        
Mon^Min     , Mon^StrB    , Mon^StrB    , Mon^StrB    , Mon^StrB    , Mon^StrB    , Mon^StrB    , Mon         , Mon         , Lp          , Mon         , Lh          , Mon         , Mon         , Mon         , Lh          , Lh          , Lh          , Lh          , Mon         , Mon         , Mon         , Strs        , Strs        , Mon         , Mon         , Mon         , Mon         , Mon         , Strs        , Strs        , Strs^Af     , Strs        , Strs        
Lp          , Mon^StrB    , Lh          , Mon^StrB    , Mon         , Mon^StrB    , Mon^StrB    , Mon         , Mon         , Ce          , Mon         , Mon         , Mon         , Mon         , Mon         , Mon         , Strs        , Mon         , Mon         , Mon         , Mon         , Mon         , Mon         , Mon^Rre     , Mon         , Mon         , Lp          , Lh          , Mon         , Mon^Fty     , Strs        , Strs        , Strs        , Strs        
Strs        , Strs^Af     , Strs^Af     , Lh          , Lh          , Mon         , Mon^Rfr     , Mon         , Strs        , Strs        , Strs        , Mon         , Strs        , Strs        , Mon         , Mon         , Mon^Rba     , Strs        , Mon         , Mon         , Mon         , Mon         , Mon         , Lh          , Lh          , Mon         , Mon         , Lh          , Mon         , Strs        , Mon         , Strs        , Strs        , Strs        
Strs        , Strs^Af     , Strs^Af     , Lp          , Strs        , Lh          , Strs        , Strs        , Strs        , Strs        , Strs        , Strs        , Strs        , Lp          , Strs        , Strs        , Strs        , Mon         , Strs        , Mon         , Strs        , Mon         , Mon         , Mon         , Mon         , Mon         , Mon         , Mon         , Lh          , Mon         , Mon         , Strs        , Strs        , Strs        
Strs        , Strs^Af     , Strs        , Strs        , Strs        , Strs        , Strs        , Strs        , Strs        , Strs        , StrC        , Strs        , Strs        , Strs        , Strs        , Strs        , Pln         , Strs        , Strs        , Strs        , Strs        , Strs        , Strs        , Strs        , Mon^Rge     , Mon         , Mon         , Lh          , Lh          , Lh          , Mon         , Strs        , Strs        , Strs        
Strs        , Strs        , Strs        , Strs        , Strs        , Strs        , Strs^Af     , Strs        , Strs        , Strs        , StrC        , StrC        , Strs        , Strs        , Strs        , Strs        , Strs        , Strs        , Strs        , Strs        , Strs        , Strs        , Strs        , Strs        , Strs        , Mon         , Mon         , Mon         , Mon         , Mon         , Mon         , Mon^Fty     , Strs        , Strs        
Strs        , Strs        , Strs        , Strs        , Strs        , Strs        , Strs^Af     , Strs^Af     , Strs        , Strs        , Strs        , Strs        , Strs        , Strs        , Strs        , Strs        , Strs        , Strs        , Strs        , Strs        , Strs        , Strs        , Strs        , Strs        , Strs        , Mon         , Mon         , Mon^Af      , Mon^Af      , Mon         , Mon         , Mon         , Mon         , Strs        
Strs        , Strs        , Pln         , Strs        , Strs        , Strs        , Strs        , Strs^Af     , Strs^Af     , Strs        , Strs        , Strs        , Strs        , Strs        , Strs        , Strs        , Strs        , Strs        , Strs^Af     , Strs        , Strs        , Strs        , Strs        , Strs        , Strs        , Mon         , Mon         , Mon         , Mon         , Mon         , Mon         , Mon         , Mon         , Strs        
Strs        , Strs        , Strs        , Strs        , Strs        , Strs        , Strs        , Strs^Af     , Strs        , Strs        , Strs        , Strs        , Strs        , Strs        , Strs        , Strs        , Strs        , Strs        , Strs^Af     , Strs        , Strs        , Strs        , Strs        , Strs        , Strs        , Strs        , Mon^Rea     , Mon         , Mon         , Mon         , Mon         , Mon         , Strs        , Mon         
Strs^Af     , Strs        , Strs        , Strs        , Strs        , Strs        , Strs        , Strs        , Strs        , Strs        , Strs        , Strs        , Pln         , Strs        , Strs        , Strs        , Strs        , Strs        , Strs        , Strs^Af     , Strs^Af     , Strs^Af     , Strs        , Strs        , Strs        , Strs        , Strs        , Strs        , Mon         , Lp          , Mon         , Mon         , Strs        , Strs        
Strs^Af     , Strs^Af     , Strs        , Strs        , Strs        , Strs        , Strs        , Strs        , Strs        , Strs        , Strs        , Strs        , Strs        , Strs        , Strs        , Strs        , Strs        , Strs        , Strs        , Strs        , Strs        , Strs        , Strs        , Strs        , Strs        , Strs        , Strs        , Mon         , Lp          , Mon         , Mon         , Mon         , Mon^Fre     , Mon         
Strs^Af     , Strs^Af     , Strs        , Strs        , Pln         , Strs        , Strs        , Strs        , Strs        , Strs        , Strs        , Strs        , Strs        , Strs        , Strs        , Strs        , Strs        , Strs        , Strs        , Strs        , Strs        , Strs        , Strs        , Pln         , Strs        , Strs        , Strs        , Mon         , Mon         , Mon         , Mon         , Mon         , Strs        , Mon         
Strs^Af     , Strs^Af     , Strs        , Strs        , Strs        , Strs        , Strs        , Strs        , Strs        , Strs^Af     , Strs^Af     , Strs        , Strs^Af     , Strs        , Strs        , Strs        , Strs        , Strs        , Strs        , Strs        , Strs        , Strs        , Strs        , Strs        , Strs        , Strs        , Strs        , Strs        , Mon         , Lp          , Mon         , Mon         , Mon         , Strs        
Strs        , Strs        , Strs        , Strs        , Strs        , Strs        , Strs        , Strs        , Strs        , Strs        , Strs        , Strs        , Strs^Af     , Strs        , Strs        , Strs        , Strs        , Strs        , StrC        , Strs        , Strs        , Strs        , Strs        , Strs        , Strs        , Strs        , Strs        , Strs        , Mon         , Mon         , Mon         , Mon         , Strs        , Strs        
Strs        , Strs        , Strs        , Strs        , Strs        , Strs        , Strs        , Strs        , Strs        , Strs        , Strs        , Strs        , Strs        , Strs        , Strs        , Strs        , Strs        , StrC        , StrC        , StrC        , StrC        , Strs        , Strs        , Strs        , Strs        , Strs        , Strs        , Strs        , Mon         , Mon         , Mon         , Mon         , Mon         , Strs        
Strs        , Strs        , Strs        , Strs        , Strs        , Strs        , Strs        , Strs        , StrC        , Strs        , Strs        , Strs        , Strs        , Strs        , Strs        , Strs        , Strs        , StrC        , StrC        , StrC        , Strs        , StrC        , Strs        , Strs        , Strs        , Strs        , Strs        , Mon^Fre     , Mon         , Mon         , Mon         , Mon         , Mon         , Mon         
Strs        , Strs        , Strs        , Strs        , StrC        , StrC        , StrC        , StrC        , StrC        , Strs        , Strs        , Strs        , Pln         , Strs        , Strs        , Strs        , Strs        , Strs        , Strs        , Strs        , Strs        , Strs        , Strs        , Strs        , Lh          , Strs        , Mon         , Mon         , Mon^StrB    , Mon^StrB    , Mon^StrB    , Mon         , Mon         , Strs        
Strs        , Strs        , Strs        , Strs        , Strs        , StrC        , StrC        , StrC        , Strs        , Strs        , Strs        , Strs        , Strs        , Strs        , Strs        , Strs        , Strs        , Strs        , Strs        , Strs        , Strs        , Strs        , Strs        , Lh          , Lp          , Mon         , Mon         , Mon         , Mon^StrB    , 1 Mon^StrK  , Mon         , Mon         , Mon         , Mon         
Strs        , Strs        , Strs        , Strs        , Strs        , Strs        , Strs        , Strs        , Strs        , Strs        , Strs        , Strs        , Strs        , Strs        , Strs^Af     , Strs        , Strs^Af     , Strs^Af     , Strs^Af     , Strs        , Strs        , Strs        , Lh          , Lp          , Lp          , Lp          , Mon         , Mon         , Mon         , Mon         , Mon         , Mon         , Mon         , Mon         
Strs        , Pln         , Strs        , Strs        , Strs        , Strs        , Strs        , Strs        , Strs        , Strs        , Strs        , Strs^Af     , Strs^Af     , Strs^Af     , Strs^Af     , Strs^Af     , Strs^Af     , Strs^Af     , Strs^Af     , Strs        , Strs        , Strs        , Strs        , Lh          , Lh          , Lp          , Lh          , Mon         , Mon         , Mon         , Mon         , Mon         , Mon         , Mon         
