border_size=1
usage=map

Mon         , Mon         , Mon         , Mon         , Mon         , Strs        , Strs        , Strs        , Strs        , Strs        , Strs        , Strs        , Strs        , Strs        , Strs        , Strs        , Strs        , Strs        , Strs        , Strs        , Strs        , Strs        , Strs        , Strs        , Strs        , Strs        , Strs        , Strs        , Strs        , Strs        , Strs        , Strs        , Strs        , Strs        , Strs        , Strs        , Strs        , Strs        , Strs        , Strs        , Strs        , Strs        , Strs        , Strs        , Strs        , Strs        , Strs        , Strs        , Strs        , Strs        , Strs        , Strs        , Strs        , Strs        , Strs        , Strs        , Strs        , Strs        , Strs        , Strs        , Strs        , Strs        , Strs        , Strs        , Strs        , Strs        , Strs        , Strs        , Strs        , Strs        , Strs        , Strs        , Strs        , Strs        , Strs        , Strs        , Strs        , Strs        , Strs        , Strs        , Strs        
Mon         , Mon         , Mon         , Mon         , Mon         , Mon         , Strs        , Strs        , Strs        , Strs        , Strs^Af     , Strs        , Strs        , Strs        , Strs        , Strs        , Strs        , Strs        , Strs        , Strs        , Strs        , Strs        , Strs        , Strs        , Strs        , Strs        , Strs        , Strs        , Strs        , Strs        , Strs        , Strs        , Strs        , Strs        , Strs        , Strs        , Strs        , Strs        , Strs        , Strs        , Strs        , Strs        , Strs        , Strs        , Strs        , Strs        , Strs        , Strs        , Strs        , Strs        , Strs        , Strs        , Strs        , Strs        , Strs        , Strs        , Strs        , Strs        , Strs        , Strs        , Strs        , Strs        , Strs        , Strs        , Strs        , Strs        , Strs        , Strs        , Strs        , Strs        , Strs        , Strs        , Strs        , Strs        , Strs        , Strs        , Strs        , Strs        , Strs        , Strs        , Strs        
Mon         , Mon         , Mon^StrB    , Mon^StrB    , Mon^StrB    , Strs        , Mon         , Mon         , Mon         , Strs        , Strs        , Strs        , Strs        , Pln         , Strs        , Strs        , Strs        , Strs        , StrC        , StrC        , StrC        , Strs        , Strs        , Strs        , Pln         , Strs        , Strs        , Strs        , Strs        , Strs        , StrC        , Strs        , Strs        , StrC        , StrC        , StrC        , StrC        , Strs        , Strs        , Strs        , Strs        , Pln         , Strs        , Strs        , Strs        , Strs        , Strs        , Strs^Af     , Strs^Af     , Strs^Af     , Strs^Af     , Strs^Af     , Strs        , Strs        , Strs        , Strs        , Pln         , Strs        , Strs        , Strs        , Strs        , Strs        , Strs^Af     , Strs        , Strs        , Strs        , Strs        , Strs        , Pln         , Strs        , Strs        , Strs        , Strs^Af     , Strs        , Strs        , Strs        , Strs        , Strs        , Lp          , Lp          , Mon         
Mon         , Mon^StrB    , Mon^StrB    , 2 Mon^StrK  , Mon^StrB    , Mon         , Mon         , Mon         , Mon         , Mon         , Mon         , Strs        , Strs        , Strs        , Strs        , Strs        , Strs        , Strs        , StrC        , Strs        , StrC        , Strs        , Strs        , Strs        , Strs        , Strs        , Strs        , Strs        , Strs        , Strs        , Strs        , StrC        , Strs        , Strs        , Strs        , Strs        , Strs        , Strs        , Strs        , Strs^Af     , Strs        , Strs        , Strs        , Strs        , Strs        , Strs        , Strs        , Strs        , Strs        , Strs        , Strs        , Strs        , Strs        , Strs        , Strs        , Strs        , Strs        , Strs        , Strs        , Strs        , Strs        , Strs        , Strs        , Strs^Af     , Strs^Af     , Strs        , Strs        , Strs        , Strs        , Strs        , Strs        , Strs        , Strs^Af     , Strs        , Strs        , Strs        , Mon         , Mon         , Mon         , Mon         , Mon         
Mon         , Mon^StrB    , Mon^StrB    , Mon^StrB    , Mon^StrB    , Mon         , Mon         , Mon^Rfr     , Mon         , Mon         , Mon         , Strs        , Strs        , Strs^Af     , Strs        , Strs        , Strs        , Strs        , Strs        , Strs        , Strs        , Strs        , Strs        , Strs^Af     , Strs^Af     , Strs^Af     , Strs^Af     , Strs^Af     , Strs        , Strs        , Strs        , Strs        , Strs        , Strs        , Strs        , Strs        , Strs        , Strs        , Strs        , Strs        , Strs        , Strs        , Strs        , Strs        , Mon^Fty     , Strs        , Lh          , Strs        , Lp          , Strs        , Strs        , Strs        , Lp          , Strs        , Strs        , Strs        , Strs        , Strs        , Strs        , Strs        , Strs        , Strs        , Strs        , Strs        , Strs        , Strs^Af     , Strs        , Strs        , Strs        , Strs        , Strs^Af     , Strs^Af     , Strs        , Strs        , Strs        , Strs        , Mon         , Mon         , Mon         , Mon         , Mon         
Mon         , Mon         , Mon         , Mon^StrB    , Mon         , Mon         , Mon         , Mon         , Mon         , Mon         , Mon         , Strs        , Mon         , Strs        , Strs        , Strs        , Strs        , Strs        , Strs        , StrC        , Strs        , Strs        , Strs        , Strs        , Strs        , Strs        , Strs        , Strs        , Strs        , Strs        , Mon         , Strs        , Mon         , Strs        , Mon         , Strs        , Mon^Rba     , Mon         , Mon         , Strs        , Mon         , Strs        , Mon         , Mon         , Mon         , Mon         , Mon         , Lh          , Lh          , Lp          , Lp          , Lp          , Lh          , Lh          , Mon         , Mon^Fre     , Mon         , Strs        , Lh          , Lh          , Lh          , Strs        , Lh          , Strs        , Strs        , Strs        , Strs        , Strs        , Strs        , Strs        , Strs        , Strs        , Strs        , Strs        , Lp          , Lh          , Mon         , Mon^Gen     , Mon         , Mon         , Mon         
Mon         , Mon         , Mon         , Mon         , Mon         , Mon^Af      , Mon^Af      , Mon         , Mon         , Mon         , Mon         , Mon         , Mon         , Mon         , Mon^Rge     , Mon         , Mon         , Strs        , Strs        , Strs        , Mon         , Strs        , Mon         , Strs        , Mon         , Mon         , Mon         , Mon^Fty     , Mon         , Mon         , Mon         , Mon         , Mon         , Mon         , Lh          , Mon         , Mon         , Mon         , Mon^Af      , Mon         , Mon         , Mon         , Mon         , Mon         , Mon         , Mon         , Lh          , Mon         , Mon         , Lh          , Lh          , Lh          , Mon         , Lh          , Mon         , Mon         , Mon         , Mon         , Mon         , Mon         , Mon         , Lh          , Mon         , Mon         , Mon         , Strs        , Strs        , Strs        , Strs        , Strs        , Strs        , Strs        , Lh          , Lp          , Mon         , Mon         , Mon         , Mon         , Mon         , Mon         , Mon         
Mon         , Mon         , Mon^Rba     , Mon         , Mon         , Mon^Af      , Mon         , Mon         , Mon         , Mon         , Lh          , Mon         , Mon         , Mon         , Mon         , Mon         , Lh          , Mon         , Mon         , Mon         , Mon         , Mon         , Mon         , Lh          , Mon         , Mon         , Mon         , Mon         , Mon         , Mon         , Mon         , Mon         , Mon         , Lh          , Lh          , Mon         , Mon         , Mon         , Mon^Af      , Mon^Af      , Mon         , Mon         , Mon^Fre     , Mon         , Mon         , Mon         , Lh          , Lh          , Mon         , Mon         , Mon         , Mon         , Mon         , Mon         , Mon         , Mon         , Mon         , Mon         , Mon^Rea     , Mon         , Mon         , Mon         , Mon^Af      , Mon         , Mon         , Mon         , Mon^Rea     , Strs        , Lp          , Strs        , Strs        , Strs        , Mon         , Mon         , Mon         , Mon         , Mon         , Mon         , Mon         , Mon         , Mon         
Mon         , Mon         , Mon         , Mon         , Mon         , Mon         , Mon         , Mon         , Mon         , Lh          , Lh          , Lh          , Mon         , Mon         , Mon         , Mon         , Mon         , Lh          , Mon         , Mon         , Mon         , Mon         , Mon^Af      , Mon         , Mon^Af      , Mon         , Mon         , Mon^Rba     , Mon         , Mon         , Mon         , Mon         , Mon         , Mon         , Mon         , Mon         , Mon         , Mon         , Mon         , Mon         , Mon         , Mon         , Mon         , Mon         , Mon         , Mon         , Mon         , Mon         , Mon         , Mon^Af      , Mon         , Mon         , Mon         , Mon         , Mon         , Mon         , Mon         , Mon         , Mon         , Mon         , Mon         , Mon         , Mon^Af      , Mon         , Mon         , Mon         , Mon         , Mon         , Mon         , Lp          , Mon         , Mon         , Mon^Fty     , Mon         , Mon         , Mon         , Mon         , Mon         , Mon         , Mon^Fre     , Mon         
Strs        , Mon         , Lh          , Mon         , Mon         , Mon         , Mon         , Mon         , Mon^Rfr     , Mon         , Mon         , Lh          , Mon         , Mon         , Mon^Af      , Mon         , Mon         , Mon         , Mon         , Mon         , Mon         , Mon         , Mon         , Mon^Af      , Mon         , Mon         , Mon         , Mon         , Mon         , Mon         , Mon         , Mon         , Mon         , Mon         , Mon         , Mon         , Mon         , Mon         , Mon         , Mon         , Mon^Fty     , Mon         , Mon         , Mon         , Strs        , Mon         , Mon         , Mon         , Mon^Rea     , Mon         , Mon         , Mon         , Lp          , Lp          , Lp          , Lp          , Lh          , Mon         , Mon         , Mon         , Mon^Gen     , Mon         , Mon         , Mon         , Mon         , Mon         , Mon         , Mon         , Mon         , Mon         , Mon         , Mon         , Mon         , Mon         , Mon         , Mon         , Mon         , Mon         , Mon         , Mon         , Mon         
Strs        , Strs        , Strs        , Lh          , Lh          , Mon         , Mon         , Mon         , Mon         , Mon         , Mon         , Mon         , Mon         , Mon^Af      , Mon         , Mon         , Mon^Rfr     , Mon         , Mon         , Mon         , Mon         , Mon         , Mon^Fty     , Mon         , Lh          , Mon         , Mon         , Mon         , Mon         , Mon         , Mon         , Mon^Fty     , Strs        , Lp          , Lp          , Lp          , Lp          , Mon         , Strs        , Strs        , Strs        , Strs        , Strs        , Strs        , Strs        , Strs        , Strs        , Strs        , Strs        , Strs        , Strs        , Lh          , Strs        , Strs        , Strs        , Strs        , Strs        , Strs        , Strs        , Strs        , Strs        , Mon         , Lh          , Lh          , Lp          , Mon         , Mon         , Mon         , Mon         , Mon         , Mon         , Mon         , Mon         , Mon         , Mon         , Mon^Gen     , Mon         , Strs        , Mon         , Mon         , Mon         
Strs        , Strs        , Strs        , Strs        , Strs        , Lh          , Lh          , Mon         , Mon         , Mon         , Mon         , Mon         , Mon         , Mon         , Mon         , Mon         , Mon         , Mon         , Lh          , Lh          , Lh          , Lh          , Lh          , Lh          , Lp          , Lh          , Strs        , Strs        , Strs^Af     , Strs        , Strs        , Strs        , Strs        , Strs        , Strs        , Strs        , Strs        , Strs        , Strs        , Strs        , Strs        , Strs        , Strs        , Strs        , Strs^Af     , Strs        , Strs        , Strs        , Strs        , Strs        , Strs        , Strs        , Strs        , Strs        , Strs        , Strs        , Strs        , Strs        , Strs        , Strs        , Strs        , Strs        , Strs        , Lp          , Lp          , Lh          , Lh          , Mon         , Mon         , Mon         , Mon         , Mon         , Mon^StrB    , Mon^StrB    , Mon^StrB    , Mon         , Mon         , Mon         , Mon         , Mon         , Mon         
Strs        , Pln         , Strs        , Strs        , Strs        , Strs        , Lh          , Mon         , Mon         , Mon         , Mon         , Mon^Rge     , Mon         , Mon         , Lh          , Lh          , Lh          , Lh          , Lp          , Lh          , Lp          , Lp          , Lp          , Lp          , Strs        , Strs        , Strs^Af     , Strs^Af     , Strs        , Strs^Af     , Strs        , Strs        , Strs        , Strs        , Strs        , Strs        , Strs        , Strs        , Strs        , Strs        , Strs        , Strs        , Strs        , Strs        , Strs^Af     , Strs        , Strs^Af     , Strs        , Strs        , Strs        , Strs        , Strs        , Strs        , Strs        , Strs        , Strs        , Strs        , Strs^Af     , Strs^Af     , Strs        , Strs        , Strs        , Strs        , Strs        , Lh          , Lh          , Mon         , Mon         , Mon         , Mon         , Mon         , Mon         , Mon^StrB    , Mon^StrB    , Mon^StrB    , Mon         , Mon         , Mon         , Mon         , Mon^Fre     , Mon         
Strs        , Strs        , Strs^Af     , Strs        , Strs        , Strs        , Strs        , Lh          , Strs        , Mon         , Mon         , Mon         , Lh          , Lh          , Lp          , Lp          , Lp          , Lp          , Strs        , Lp          , Strs        , Strs        , Strs        , Strs        , Strs        , Strs        , Strs        , Strs        , Strs        , Strs        , Strs        , Strs        , Strs        , StrC        , StrC        , Strs        , Strs        , Strs        , Strs        , Strs        , Pln         , Strs        , Strs        , Strs        , Strs        , Strs        , Strs        , Strs^Af     , Strs        , Strs        , Strs        , Pln         , Strs        , Strs        , Strs        , Strs        , Strs        , Strs        , Strs^Af     , Strs        , Strs        , Strs        , Strs        , Strs        , Mon^Rea     , Mon         , Mon         , Mon         , Mon         , Mon         , Mon         , Mon         , Mon^StrB    , 1 Mon^StrK  , Mon^StrB    , Mon^Fty     , Mon         , Mon         , Mon         , Mon         , Mon         
Strs        , Strs        , Strs^Af     , Strs        , StrC        , Strs        , Strs        , Strs        , Strs        , Strs        , Strs        , Strs        , Strs        , Strs        , Strs        , Strs        , Strs        , Strs        , Strs        , Strs        , Strs        , Strs        , Strs        , Strs        , Strs        , Strs        , Strs        , Pln         , Strs        , Strs        , Strs        , Strs        , StrC        , StrC        , Strs        , StrC        , StrC        , Strs        , Strs        , Strs        , Strs        , Strs        , Strs        , Strs        , Strs        , Strs        , Strs^Af     , Strs^Af     , Strs        , Strs        , Strs        , Strs        , Strs        , Strs        , Strs        , Strs^Af     , Strs^Af     , Strs        , Strs^Af     , Strs        , Strs        , Strs        , Mon         , Mon         , Mon         , Mon         , Mon         , Strs        , Mon         , Mon         , Mon         , Mon         , Mon^StrB    , Mon^StrB    , Mon^StrB    , Mon         , Mon         , Mon         , Mon         , Mon         , Mon         
Strs        , Strs^Af     , Strs        , Strs        , Strs        , StrC        , Strs        , StrC        , Strs        , Strs        , Strs        , Strs        , Strs        , Strs        , Strs        , Strs        , Strs        , StrC        , StrC        , StrC        , StrC        , StrC        , Strs        , Strs        , Strs        , Strs        , Strs        , Strs        , Strs        , Strs        , Strs        , Strs        , Strs        , Strs        , Strs        , Strs        , Strs        , Strs        , Strs        , Strs        , Strs        , Strs        , Strs        , Strs        , Strs        , Strs        , Strs        , Strs        , Strs        , Strs        , Strs        , Strs        , Strs        , Strs        , Strs        , Strs        , Strs        , Strs        , Strs        , Strs        , Strs        , Strs        , Mon         , Mon         , Mon         , Mon         , Mon         , Mon         , Mon         , Mon         , Mon         , Mon         , Mon         , Mon^StrB    , Mon         , Mon         , Mon         , Mon         , Mon         , Mon         , Mon         
Strs        , Strs        , Strs        , Strs        , Strs        , Strs        , Strs        , Strs        , Strs        , Strs        , Strs        , Strs        , Strs        , Strs        , Strs        , Strs        , Strs        , Strs        , Strs        , Strs        , Strs        , Strs        , Strs        , Strs        , Strs        , Strs        , Strs        , Strs        , Strs        , Strs        , Strs        , Strs        , Strs        , Strs        , Strs        , Strs        , Strs        , Strs        , Strs        , Strs        , Strs        , Strs        , Strs        , Strs        , Strs        , Strs        , Strs        , Strs        , Strs        , Strs        , Strs        , Strs        , Strs        , Strs        , Strs        , Strs        , Strs        , Strs        , Strs        , Strs        , Strs        , Strs        , Strs        , Mon         , Strs        , Mon         , Mon         , Mon         , Mon         , Mon         , Mon^Gen     , Mon         , Mon         , Mon         , Mon         , Mon         , Mon         , Mon         , Mon         , Mon         , Strs        
