border_size=1
usage=map

Strs        , Strs        , Strs        , Strs        , Strs        , Strs        , Strs        , Strs        , Strs        , Lh          , Lp          , Lp          , Lp          , Lh          , Lh          , Mon         , Mon         , Mon         , Mon         , Mon         , Mon         , Mon         , Mon         , Mon         , Mon         , Mon         , Mon         , Mon         , Mon         , Mon         , Mon         , Mon         , Mon         , Mon         , Mon         , Mon         , Mon         , Mon         , Strs        , Strs        , Strs        , Strs        , StrC        , Strs        , StrC        , Strs        
Strs        , Strs        , Strs        , Strs        , Strs        , Strs        , Strs        , Strs        , Strs        , Lh          , Lp          , Lp          , Lp          , Lh          , Lh          , Mon         , Mon         , Mon         , Mon         , Mon         , Mon         , Mon         , Mon         , Mon         , Mon         , Mon         , Mon         , Mon         , Mon         , Mon         , Mon         , Mon         , Mon         , Mon         , Mon         , Mon^Fty     , Mon         , Mon         , Strs        , Strs        , Strs        , StrC        , Strs        , Strs        , Strs        , Strs        
Strs        , Strs        , Strs        , Pln         , Strs        , Strs        , Strs^Af     , Strs^Af     , Strs        , Lh          , Lh          , Lp          , Lh          , Lh          , Mon         , Mon         , Mon         , Mon         , Lh          , Lh          , Lh          , Mon         , Mon         , Mon         , Mon         , Mon^Fre     , Mon         , Mon         , Mon         , Mon         , Mon^StrB    , Mon         , Mon         , Mon         , Mon         , Mon         , Mon         , Mon         , Strs        , Strs^Af     , Strs^Af     , Strs        , Strs        , Pln         , Strs        , Strs        
Strs        , Strs        , Strs        , Strs        , Strs        , Strs        , Strs        , Strs        , Strs        , Re          , Re          , Lh          , Mon^Rge     , Mon         , Mon         , Mon         , Lh          , Mon^Min     , Lh          , Lh          , Lh          , Mon         , Mon         , Mon         , Mon         , Mon         , Mon         , Mon         , Mon         , Mon^StrB    , 4 Mon^StrK  , Mon^StrB    , Mon         , Mon         , Mon         , Mon         , Mon         , Strs        , Strs        , Strs        , Strs        , Strs        , Strs        , Strs        , Strs        , Strs        
Strs        , Strs        , Strs        , Strs        , Strs        , StrC        , Strs        , Strs        , Strs        , Gs^Fds      , Gs^Fds      , Re          , Mon         , Mon         , Mon         , Mon         , Lh          , Lp          , Lp          , Lp          , Lh          , Lh          , Re          , Mon         , Mon         , Mon         , Mon         , Mon         , Mon         , Mon^StrB    , Mon^StrB    , Mon^StrB    , Mon         , Mon         , Mon         , Mon         , Mon         , Strs        , Strs        , Strs        , Strs        , Strs        , Strs        , Strs        , Strs        , Strs        
Strs        , Strs        , Strs^Af     , Strs        , Strs        , Strs        , Pln         , Strs        , Strs        , Gs^Fds      , Re          , Re          , Mon         , Mon         , Mon         , Mon         , Lh          , Lp          , Lp          , Lh          , Re          , Re          , Gs^Fds      , Re          , Mon         , Mon         , Mon         , Mon         , Mon         , Mon         , Mon         , Mon         , Mon         , Re          , Re          , Mon^Fre     , Mon         , Strs        , Strs        , Pln         , Strs        , Strs        , Strs^Af     , Strs^Af     , Strs        , Strs        
Strs        , Strs        , Strs^Af     , Strs^Af     , Strs^Af     , Strs        , Strs        , Strs        , Strs        , Strs        , Strs        , Mon         , Lh          , Mon^Rfr     , Lh          , Mon         , Lh          , Lp          , Re          , Re          , Gs^Fds      , Gs^Fds      , Gs^Fds      , Re          , Mon         , Mon^Dr      , Mon         , Mon         , Mon         , Mon         , Mon         , Mon         , Mon         , Re          , Mon         , Mon         , Mon         , Strs        , Strs        , Strs        , Strs        , Strs        , Strs^Af     , Strs        , Strs        , Strs        
Strs        , Strs        , Strs        , Strs        , Strs        , Strs        , Strs        , Strs        , Strs^Af     , Strs        , Strs        , Mon         , Lh          , Lh          , Lp          , Lh          , Lp          , Lp          , Re          , Gs^Fds      , Gs^Fds      , Gs^Fds      , Re          , Re          , Mon         , Mon         , Mon         , Mon         , Mon         , Mon         , Mon         , Mon         , Mon^Dr      , Mon         , Mon         , Mon         , Mon         , Strs        , Strs        , Strs        , Strs        , Strs^Af     , Strs        , Strs        , Strs        , Strs        
Strs        , Strs        , Strs        , Strs        , Strs        , Strs        , Strs        , Strs^Af     , Strs^Af     , Strs        , Strs        , Mon         , Lh          , Lp          , Lp          , Lp          , Lh          , Lh          , Mon         , Re          , Re          , Re          , Mon         , Mon         , Mon         , Mon         , Mon         , Mon^Fty     , Mon         , Mon         , Mon         , Mon         , Mon         , Mon         , Mon         , Mon         , Strs        , Strs        , Strs        , Strs        , Strs        , Strs        , Strs        , Strs        , Strs        , Strs        
Strs        , Strs        , Strs        , Pln         , Strs        , Strs        , StrC        , Strs        , Strs        , Strs        , Strs        , Mon         , Mon         , Lh          , Lh          , Lh          , Mon         , Mon         , Mon         , Mon         , Mon         , Mon         , Mon         , Mon         , Mon         , Mon         , Mon         , Mon         , Mon         , Mon         , Mon         , Mon         , Mon         , Mon         , Strs        , Strs        , Strs        , Strs        , Strs        , Strs^Af     , Strs        , Strs        , Strs        , Strs        , Strs        , Strs        
Strs        , Strs        , Strs        , Strs        , Strs        , Strs        , Strs        , StrC        , Strs        , Strs        , Strs        , Mon         , Mon         , Lh          , Lh          , Lh          , Mon         , Mon         , Mon         , Mon         , Mon^Dr      , Mon         , Mon         , Mon         , Mon         , Mon         , Re          , Re          , Re          , Mon         , Mon         , Mon         , Strs        , Strs        , Strs        , Strs        , Strs        , Strs        , Strs        , Strs^Af     , Strs        , Strs        , Pln         , Strs        , Strs        , Strs        
Strs        , Strs        , Strs^Af     , Strs        , Strs^Af     , Strs^Af     , Strs        , Strs        , Pln         , Strs        , Strs        , Strs        , Mon^Rge     , Mon         , Mon         , Mon         , Mon         , Mon         , Mon         , Mon         , Mon         , Mon         , Mon         , Mon         , Mon^Gen     , Mon         , Mon         , Re          , Mon         , Mon         , Mon         , Mon         , Strs        , Strs        , Strs^Af     , Strs^Af     , Strs        , Strs        , Strs        , Strs        , Strs        , Strs        , Strs        , Strs        , Strs        , Strs        
Strs        , Strs        , Strs        , Strs^Af     , Strs        , Strs        , Strs        , Strs        , Strs        , Strs        , Strs        , Strs        , Mon         , Mon         , Mon^StrB    , Mon^StrB    , Mon^StrB    , Mon         , Mon         , Mon         , Mon         , Mon         , Mon         , Mon         , Mon         , Mon         , Mon         , Mon         , Mon         , Mon         , Lh          , Mon         , Strs        , Strs        , Strs^Af     , Strs        , Strs        , Pln         , Strs        , Strs        , Strs        , Strs        , Strs^Af     , Strs        , Strs        , Strs        
Strs        , Strs        , Strs        , Strs        , Strs        , Strs        , Strs        , Strs        , Strs        , Strs        , Gs^Fds      , Mon         , Mon         , Mon         , Mon^StrB    , 3 Mon^StrK  , Mon^StrB    , Mon         , Mon         , Mon         , Mon         , Mon         , Mon         , Mon         , Mon         , Mon         , Mon         , Mon         , Mon         , Mon         , Lh          , Lh          , Strs        , Strs        , Strs^Af     , Strs        , Strs        , Strs        , StrC        , Strs        , Strs        , Strs^Af     , Strs^Af     , Strs^Af     , Strs        , Strs        
Strs        , Strs        , Strs        , Strs        , Pln         , Strs        , Strs        , Strs        , StrC        , Strs        , Lh          , Mon         , Mon         , Mon         , Mon         , Mon^StrB    , Mon         , Mon         , Mon         , Mon^Fty     , Mon         , Mon         , Mon         , Mon         , Mon         , Mon^Dr      , Mon         , Mon         , Mon         , Mon         , Mon^Fty     , Lp          , Strs        , Strs        , Strs        , Strs        , Strs        , Strs        , Strs        , Strs        , Strs        , Strs        , Strs        , Strs        , Strs        , Strs        
Strs        , Strs        , Strs        , Strs        , Strs        , Strs        , Strs        , StrC        , StrC        , Lh          , Lh          , Lh          , Mon         , Mon         , Mon         , Mon         , Mon         , Mon         , Mon         , Mon         , Mon         , Mon         , Mon         , Mon         , Mon         , Mon         , Mon         , Mon         , Mon         , Mon         , Lh          , Lp          , Strs        , Strs        , Strs        , Strs        , Strs        , Strs        , Strs        , Strs        , Strs        , Strs        , Strs        , Strs        , Strs        , Strs        
Strs        , Strs        , Strs        , Strs        , Strs^Af     , Strs^Af     , Strs^Af     , Strs        , Strs        , Lh          , Lh          , Lh          , Mon^Rfr     , Mon         , Mon         , Mon         , Mon         , Mon         , Mon         , Mon         , Mon         , Mon         , Mon         , Mon         , Re          , Mon         , Mon         , Mon         , Lh          , Lh          , Lp          , Mon^Min     , Strs        , Strs        , StrC        , Strs        , Strs        , Strs        , Strs^Af     , Strs        , Strs        , Pln         , Strs        , Strs        , Strs        , Strs        
Strs        , Strs        , Strs        , Strs^Af     , Strs        , Strs        , Strs        , Strs        , Strs        , Lh          , Lh          , Lh          , Lh          , Mon         , Mon         , Mon         , Re          , Mon         , Mon         , Mon         , Mon         , Mon         , Re          , Re          , Gs^Fds      , Re          , Lh          , Lh          , Lp          , Lp          , Lp          , Lp          , Strs        , StrC        , StrC        , Strs        , Strs        , Strs^Af     , Strs^Af     , Strs^Af     , Strs^Af     , Strs        , Strs        , Strs        , StrC        , Strs        
Strs        , Strs        , Strs        , Strs        , Strs        , Strs        , Strs        , Strs        , Strs        , Strs        , Strs        , Lh          , Strs        , Mon         , Mon         , Mon         , Re          , Re          , Mon         , Mon         , Mon^Gen     , Re          , Gs^Fds      , Gs^Fds      , Strs        , Strs        , Strs        , Lp          , Lp          , Lp          , Strs        , Strs        , Strs        , Strs        , Strs        , Strs        , Strs        , Strs        , Strs        , Strs^Af     , Strs^Af     , Strs        , Strs        , StrC        , StrC        , StrC        
Strs        , Strs        , Strs        , Pln         , Strs        , Strs        , Strs        , StrC        , Strs        , Strs        , Strs        , Strs        , Strs        , Strs        , Strs        , Mon         , Mon         , Mon         , Mon         , Mon         , Strs        , Strs        , Strs        , Strs        , Strs        , Strs        , Strs        , Strs        , Strs        , Strs        , Strs        , Strs        , Strs^Af     , Strs        , Strs        , Strs        , Strs        , Strs        , Strs        , Strs        , Strs        , Strs        , Strs        , Strs        , Strs        , Strs        
Strs        , Strs        , Strs        , Strs        , Strs        , Strs        , Strs        , Strs        , Strs        , Pln         , Strs        , Strs        , StrC        , Strs        , Strs        , Mon         , Mon         , Mon         , Mon         , Mon         , Strs        , Strs        , Strs        , Strs        , Strs        , StrC        , Strs        , Strs        , Pln         , Strs        , Strs        , Strs^Af     , Strs^Af     , Strs        , Strs        , Pln         , Strs        , Strs        , Strs        , Strs        , Strs        , Strs        , Strs        , Strs        , Strs        , Strs        
Strs        , Strs        , Strs        , Strs        , Strs        , Strs^Af     , Strs^Af     , Strs        , Strs        , Strs        , Strs        , Strs        , Strs        , Strs        , Strs        , Mon^Rge     , Mon         , Mon         , Mon         , Mon         , Strs        , Strs        , Pln         , Strs        , Strs        , Strs        , Strs        , Strs        , Strs        , Strs        , Strs        , Strs        , Strs^Af     , Strs        , Strs        , Strs        , Strs        , Strs        , Strs        , StrC        , Strs        , Strs        , Pln         , Strs        , Strs        , Strs        
Strs        , Strs        , Strs        , Strs        , Strs        , Strs        , Strs        , Strs^Af     , StrC        , Strs        , Strs        , Strs        , Strs        , Strs^Af     , Strs        , Mon         , Mon         , Mon         , Mon^Dr      , Mon^Dr      , Strs        , Strs        , Strs        , Strs        , Strs        , Strs        , StrC        , Strs        , Strs        , Strs        , StrC        , Strs        , Strs        , Strs^Af     , Strs        , Strs        , Strs        , Strs        , Strs^Af     , Strs        , Strs        , Strs        , Strs        , Strs        , Strs        , Strs        
Strs        , Strs        , Strs        , Pln         , Strs        , Strs        , StrC        , StrC        , Strs        , Strs        , Strs        , Strs        , Strs        , Strs        , Strs        , Mon         , Mon         , Mon         , Mon         , Mon^Dr      , Strs        , Strs        , Strs        , Strs        , Strs        , Strs        , Strs        , Strs        , Strs        , Strs        , Strs        , Strs        , Strs        , Strs        , Strs        , Strs        , Strs        , Strs        , Strs        , Strs        , Strs        , Strs        , Strs        , Strs        , Strs        , Strs        
Strs        , Strs        , Strs        , Strs        , Strs        , Strs        , Strs        , Strs        , Mon         , Strs        , Mon         , Mon         , Mon^Dr      , Strs        , Strs        , Mon         , Mon         , Mon         , Mon         , Mon         , Strs        , Strs        , Strs        , Strs        , Strs        , Strs        , Strs        , Strs        , Strs        , Strs        , Strs        , Strs        , Strs        , Strs        , Strs        , Strs        , Strs        , Strs        , Mon         , Strs        , Mon         , Strs        , Strs        , Strs        , Strs        , Strs        
Strs        , Strs        , Strs^Af     , Strs^Af     , Strs        , Strs        , Mon         , Mon         , Mon^Fty     , Mon         , Mon         , Mon         , Mon         , Mon^Dr      , Mon         , Mon         , Re          , Re          , Mon         , Mon^Fty     , Strs        , Strs        , Mon^Af      , Strs        , Mon         , Strs        , Strs        , Strs        , Mon         , Mon         , Mon         , Mon         , Mon         , Strs        , Mon         , Mon         , Mon         , Mon         , Mon^Rba     , Mon         , Re          , Mon         , Mon         , Strs        , Mon         , Strs        
Strs        , Strs        , Strs        , Strs^Af     , Strs        , Strs        , Re          , Re          , Re          , Mon         , Mon         , Mon         , Mon         , Mon         , Lh          , Mon         , Mon         , Re          , Mon         , Mon         , Mon         , Mon^Af      , Mon         , Mon^Af      , Mon         , Mon         , Mon         , Mon^Dr      , Mon         , Mon         , Mon         , Mon^Fty     , Mon         , Mon         , Mon         , Mon         , Mon^Af      , Mon         , Mon         , Mon         , Re          , Re          , Mon         , Mon         , Mon         , Mon         
Strs        , Strs        , Strs        , Strs        , Mon         , Mon         , Re          , Gs^Fds      , Gs^Fds      , Re          , Mon         , Mon         , Mon         , Lh          , Mon^Min     , Lh          , Lh          , Mon         , Mon         , Mon         , Mon         , Mon         , Mon         , Mon         , Mon^Fty     , Mon         , Mon         , Mon         , Mon         , Mon         , Mon         , Mon         , Mon         , Mon         , Mon         , Mon         , Mon^Af      , Mon         , Mon         , Mon         , Mon         , Mon         , Mon^Af      , Mon         , Mon^Fty     , Mon         
Lh          , Lh          , Lh          , Mon         , Mon         , Mon         , Mon         , Re          , Re          , Re          , Mon         , Mon         , Mon         , Lh          , Lh          , Lh          , Lh          , Lh          , Mon^Rge     , Mon         , Mon         , Mon         , Mon         , Mon         , Mon         , Mon         , Mon         , Mon         , Mon         , Mon^Af      , Mon^Af      , Mon^Af      , Mon         , Mon         , Mon         , Mon         , Mon         , Mon^Af      , Mon^Af      , Mon         , Mon         , Mon         , Mon         , Mon^Af      , Mon         , Mon         
Lh          , Lh          , Lh          , Lh          , Lh^Af       , Mon         , Mon         , Mon         , Mon         , Mon         , Mon^StrB    , Mon         , Mon         , Lh          , Lh          , Lh          , Lh          , Lh          , Mon         , Mon         , Mon         , Mon         , Mon         , Mon         , Mon         , Mon         , Mon         , Mon         , Mon         , Mon         , Mon^Af      , Mon^Af      , Mon         , Mon         , Mon         , Mon         , Mon         , Mon         , Mon         , Mon         , Mon         , Mon         , Mon         , Mon         , Mon         , Mon         
Lh          , Lh          , Mon^Min     , Lh          , Lh          , Mon^Dr      , Mon         , Mon^Rge     , Mon         , Mon^StrB    , 2 Mon^StrK  , Mon^StrB    , Mon         , Mon         , Mon         , Lh          , Mon         , Mon         , Mon         , Mon^Af      , Re          , Mon^Af      , Mon^Af      , Mon         , Mon         , Mon         , Mon^Rba     , Mon         , Mon         , Mon         , Mon         , Mon         , Mon         , Mon         , Mon         , Mon         , Mon         , Mon         , Re          , Mon         , Mon         , Mon         , Mon         , Mon         , Mon         , Mon         
Lp          , Lp          , Lp          , Lh          , Lh          , Lh          , Mon         , Mon         , Mon         , Mon^StrB    , Mon^StrB    , Mon^StrB    , Mon         , Mon         , Mon         , Mon         , Mon         , Mon         , Mon         , Re          , Re          , Mon^Af      , Mon         , Mon         , Gs^Fds      , Mon         , Mon         , Mon         , Mon^Dr      , Mon         , Mon         , Mon         , Mon         , Mon         , Mon         , Mon^Rba     , Mon         , Re          , Re          , Mon         , Mon         , Mon^Fty     , Mon^StrB    , Mon         , Mon         , Mon         
Lp          , Lp          , Lp          , Lh          , Lh          , Lh          , Lh          , Mon         , Mon         , Mon         , Mon         , Mon         , Mon         , Mon         , Mon         , Mon         , Mon         , Mon         , Mon         , Mon         , Mon         , Mon         , Mon         , Mon         , Gs^Fds      , Gs^Fds      , Mon         , Mon         , Mon         , Mon         , Mon         , Mon         , Mon         , Mon         , Mon         , Mon         , Mon         , Re          , Re          , Mon         , Mon         , Mon^StrB    , 1 Mon^StrK  , Mon^StrB    , Mon         , Mon         
Lp          , Lp          , Lp          , Lp          , Lp          , Mon^Min     , Lh          , Lh          , Mon^Af      , Mon^Af      , Mon         , Mon         , Mon         , Mon^Fty     , Mon         , Mon         , Mon^Af      , Mon         , Mon         , Mon         , Mon         , Mon^Fty     , Mon         , Mon         , Mon         , Mon         , Mon         , Mon         , Mon^Af      , Mon         , Mon^Fty     , Mon         , Mon         , Mon         , Mon         , Mon         , Mon^Af      , Mon         , Mon         , Mon         , Mon         , Mon^StrB    , Mon^StrB    , Mon^StrB    , Mon         , Mon         
Lp          , Lp          , Lp          , Lp          , Lp          , Lh          , Lh          , Lh          , Mon         , Mon^Af      , Mon         , Mon         , Mon         , Mon         , Mon         , Mon^Af      , Mon^Af      , Mon         , Mon         , Mon         , Mon         , Mon         , Mon         , Mon         , Mon         , Mon^Af      , Mon^Af      , Mon^Af      , Mon         , Mon         , Mon         , Mon         , Mon         , Mon         , Mon^Af      , Mon^Af      , Mon         , Mon         , Mon         , Mon         , Mon         , Mon         , Mon         , Mon         , Mon         , Mon         
