border_size=1
usage=map

Mon         , Mon         , Mon         , Mon         , Mon         , Mon         , Mon         , Mon         , Mon         , Mon         , Mon         , Lh          , Lh          , Lh          , Lh          , Lh          , Lh          , Lh          , Mon         , Mon         , Mon         , Mon         , Mon         , Mon         , Mon         , Mon         , Mon         , Mon         , Mon         , Mon         , Lh          , Lh          , Mon         , Lh          , Lh          , Lh          
Mon         , Mon         , Mon^StrB    , Mon^StrB    , Mon^StrB    , Mon         , Mon^StrB    , Mon^Xxx     , Mon^StrB    , Mon^StrB    , Mon^StrB    , Mon         , Mon         , Mon         , Mon         , Mon         , Mon         , Mon         , Mon         , Mon         , Mon         , Mon         , Mon         , Mon         , Mon         , Mon         , Mon^Af      , Mon         , Mon         , Mon         , Mon         , Lh          , Lh          , Lh          , Lh          , Mon^Fty     
Lh          , Mon         , Mon^StrB    , 2 Mon^StrK  , Mon^StrB    , Mon^StrB    , 3 Mon^StrK  , Mon^StrB    , Mon^StrB    , 4 Mon^StrK  , Mon^StrB    , Mon         , Mon         , Mon         , Mon         , Mon         , Mon^Af      , Mon^Fty     , Mon^Af      , Mon         , Mon         , Mon         , Mon         , Mon         , Mon         , Mon^Af      , Mon         , Mon         , Mon         , Mon         , Mon         , Mon         , Mon         , Mon^Fre     , Mon         , Lh          
Lh          , Mon^Fre     , Mon^StrB    , Mon^StrB    , Mon^StrB    , Mon^StrB    , Mon^StrB    , Mon^StrB    , Mon^StrB    , Mon^StrB    , Mon^StrB    , Mon         , Mon         , Mon^Fty     , Mon         , Mon         , Mon         , Mon^Af      , Mon         , Mon         , Mon^Gen     , Mon         , Lh          , Lh          , Lh          , Mon         , Mon^Fty     , Mon         , Mon         , Mon         , Mon         , Mon         , Mon^Af      , Mon         , Mon         , Mon         
Lp          , Lp          , Lp          , Mon^StrB    , Lh          , Mon^StrB    , Mon^StrB    , Mon^StrB    , Lh          , Mon^StrB    , Mon         , Mon         , Mon         , Mon         , Mon         , Mon         , Mon         , Mon         , Mon         , Mon         , Lh          , Lh          , Lp          , Lp          , Lp          , Lh          , Lh          , Mon         , Mon         , Mon         , Mon         , Mon^Af      , Mon^Af      , Mon^Af      , Mon         , Mon         
Lh          , Lp          , Lp          , Lh          , Lh          , Lh          , Lh          , Lh          , Lp          , Lh          , Mon         , Mon         , Mon^Af      , Mon         , Mon         , Mon         , Lh          , Mon         , Strs        , Lh          , Strs        , Lp          , Strs        , Strs        , Strs        , Lp          , Strs        , Lh          , Mon         , Mon         , Mon         , Mon         , Mon         , Mon         , Mon         , Mon         
Strs        , Lh          , Strs        , Lp          , Strs        , Lp          , Strs^Af     , Lp          , Strs        , Lp          , Mon^Gen     , Mon         , Mon         , Mon         , Mon         , Mon         , Strs        , Strs        , Strs        , Strs        , Strs        , Strs        , Strs        , Strs        , Pln         , Strs        , Strs        , Strs        , Strs        , Mon         , Mon^Af      , Mon^Gen     , Mon         , Mon         , Mon         , Mon         
Strs        , Strs        , Strs        , Strs        , Strs^Af     , Strs^Af     , Strs^Af     , Strs        , Strs        , Strs        , Lh          , Mon         , Mon         , Mon         , Mon         , Mon         , Strs        , Strs        , Strs        , Strs^Af     , Strs        , Strs        , Strs        , Strs        , Strs        , Strs        , Strs        , Strs        , Strs        , Strs        , Mon^Af      , Mon         , Mon         , Mon         , Mon         , Mon         
Strs^Af     , Strs        , Strs        , Strs        , Strs        , Strs^Af     , Strs        , Strs        , Strs        , Strs        , Strs        , Lh          , Mon         , Mon         , Mon         , Mon         , Mon^Fre     , Strs        , Strs^Af     , Strs^Af     , Strs^Af     , Strs^Af     , Strs        , Strs        , Strs        , Strs        , Strs^Af     , Strs^Af     , Strs        , Strs        , Mon^Min     , Lh^Af       , Mon         , Mon         , Lh          , Mon         
Strs^Af     , Strs^Af     , Strs        , Strs        , Strs        , Strs        , Strs        , Strs        , Strs        , Strs        , Lp          , Lh          , Mon         , Mon         , Mon         , Mon         , Mon         , Strs        , Strs        , Strs^Af     , Strs        , Strs        , Strs        , Strs        , Strs        , Strs        , Strs^Af     , Strs^Af     , Strs        , Strs        , Lp          , Lh          , Mon         , Mon         , Lh          , Lh          
Strs^Af     , Strs^Af     , Strs        , Strs        , Pln         , Strs        , Strs        , Strs        , Pln         , Strs        , Strs        , Lh          , Mon         , Mon         , Mon^Af      , Mon         , Mon         , Strs        , Strs        , Strs        , Strs        , Strs        , Pln         , Strs        , Strs        , Strs        , Strs        , Strs^Af     , Strs        , Strs        , Lh          , Lh          , Mon         , Mon^Fty     , Lh          , Lp          
Strs^Af     , Strs        , Strs        , Strs        , Strs        , Strs        , Strs        , Strs        , Strs        , Strs        , Strs        , Strs        , Mon         , Mon^Af      , Mon         , Mon         , Lh          , Strs        , Strs        , Strs        , Strs        , Strs        , Strs        , Strs        , Strs        , Strs        , Strs        , Strs        , Strs        , Lh          , Mon^Fty     , Lh          , Mon         , Mon         , Lh          , Lh          
Strs^Af     , Strs        , Strs        , Strs        , Strs^Af     , Strs        , Strs^Af     , Strs        , Strs        , Strs        , Strs^Af     , Strs        , Strs        , Mon         , Mon         , Mon         , Lh          , Strs        , Strs        , Strs        , Strs^Af     , Strs        , Strs        , Strs        , Strs        , Pln         , Strs        , Strs        , Strs        , Mon         , Mon         , Mon         , Mon         , Mon         , Mon         , Mon         
Strs^Af     , Strs        , Strs        , Strs        , Strs        , Strs        , Strs        , Strs        , Pln         , Strs        , Strs        , Strs        , Mon^Fty     , Mon         , Mon         , Mon         , Lh          , Lp          , Strs        , Strs        , Strs        , Strs^Af     , Strs        , Strs        , Strs        , Strs        , Strs        , Strs^Af     , Strs        , Mon         , Mon         , Mon         , Lh          , Lh          , Lh          , Mon         
Strs        , Strs        , Strs        , Strs        , Pln         , Strs        , Strs        , Strs        , Strs        , Strs        , Strs^Af     , Strs        , Mon         , Mon         , Mon         , Mon         , Lh          , Lp          , Strs        , Strs        , Strs        , Strs        , Strs        , Strs        , Mon^Af      , Mon^Af      , Mon         , Strs        , Mon         , Mon         , Mon         , Mon         , Lh          , Lp          , Lp          , Lh          
Strs        , Strs        , Strs        , Strs        , Strs        , Strs        , Strs        , Strs        , Strs^Af     , Strs^Af     , Strs        , Strs        , Mon         , Mon         , Mon         , Mon         , Mon         , Lh          , Strs        , Strs        , Mon         , Strs        , Strs        , Mon^Af      , Mon         , Mon         , Mon         , Mon         , Mon         , Mon^Gen     , Lh          , Lh          , Lp          , Lp          , Lp          , Lp          
Strs        , Strs^Af     , Strs^Af     , Strs^Af     , Strs        , Strs        , Strs        , Strs        , Strs        , Strs        , Strs        , Strs        , Mon         , Mon         , Mon         , Mon         , Mon         , Mon         , Mon         , Mon         , Mon         , Mon         , Mon^Fty     , Mon         , Mon         , Mon         , Mon         , Mon         , Mon         , Lh          , Lh          , Lh          , Lp          , Lp          , Lp          , Lp          
Strs        , Strs        , Strs        , Strs        , Mon         , Lh          , Lh          , Strs        , Mon^Gen     , Mon^Af      , Mon^Af      , Mon^Af      , Mon         , Mon         , Mon         , Mon         , Mon         , Mon         , Mon         , Mon         , Mon         , Mon         , Lh          , Lh          , Lh          , Mon         , Mon         , Mon         , Mon         , Mon         , Mon^Fty     , Lh          , Lh          , Lh          , Lp          , Lp          
Strs        , Strs        , Mon         , Mon         , Mon         , Mon         , Mon         , Mon         , Mon         , Mon         , Mon         , Mon         , Mon         , Mon         , Mon         , Mon         , Mon^Fty     , Mon         , Mon         , Mon         , Mon         , Lh          , Lp          , Lp          , Lp          , Lh          , Mon         , Mon         , Mon         , Mon         , Mon         , Mon         , Mon         , Lh          , Mon         , Mon         
Mon         , Mon^Fty     , Mon         , Mon         , Mon         , Mon         , Lh          , Mon         , Mon         , Mon         , Mon         , Mon         , Mon         , Mon         , Mon         , Lh          , Lh          , Mon         , Mon         , Mon         , Mon         , Lh          , Lh          , Lh          , Lh          , Lh          , Mon         , Mon         , Mon         , Mon         , Mon         , Mon         , Mon         , Mon         , Mon         , Mon         
Mon         , Mon         , Mon         , Mon         , Lh          , Lh          , Lh          , Mon         , Mon         , Mon         , Mon         , Mon         , Mon         , Mon         , Mon         , Lh          , Mon         , Mon         , Mon         , Mon         , Mon         , Mon         , Mon         , Lh          , Mon^Xxx     , Mon         , Mon         , Mon         , Mon         , Mon         , Mon^Gen     , Mon         , Mon         , Mon         , Mon         , Mon         
Mon         , Mon         , Mon         , Lh          , Lh          , Mon^Fre     , Lh          , Mon         , Mon         , Mon         , Mon         , Mon         , Mon^Af      , Mon         , Mon         , Mon         , Mon         , Mon         , Mon         , Mon^Gen     , Mon         , Mon         , Mon         , Mon         , Mon         , Mon         , Mon         , Mon         , Mon         , Mon         , Mon^StrB    , Mon^StrB    , Mon^StrB    , Mon         , Mon         , Mon         
Mon         , Mon         , Mon         , Mon         , Mon         , Lh          , Mon         , Mon         , Mon         , Mon         , Mon         , Mon^Af      , Mon^Af      , Mon         , Mon         , Mon         , Mon         , Mon         , Mon         , Mon         , Mon         , Mon         , Mon         , Mon         , Mon         , Mon         , Mon         , Mon         , Mon         , Mon^StrB    , Mon^StrB    , 1 Mon^StrK  , Mon^StrB    , Mon^StrB    , Mon         , Mon         
Mon         , Mon         , Mon         , Mon         , Mon         , Mon         , Mon         , Mon^Gen     , Mon         , Mon         , Mon         , Mon         , Mon         , Mon         , Mon         , Mon         , Mon         , Mon         , Mon         , Mon         , Mon         , Mon         , Mon         , Mon         , Mon^Gen     , Mon         , Mon         , Mon         , Mon         , Mon         , Mon         , Mon^StrB    , Mon         , Mon         , Mon         , Mon         
Mon         , Mon^Fre     , Mon         , Mon         , Mon         , Mon         , Mon         , Mon         , Mon         , Mon         , Mon         , Mon^Fty     , Mon         , Mon         , Mon         , Lh          , Lh          , Mon^Fty     , Lh          , Mon         , Mon         , Mon         , Mon^Af      , Mon^Af      , Mon^Af      , Mon^Af      , Mon^Af      , Mon         , Mon         , Mon         , Mon         , Mon         , Mon         , Mon         , Mon         , Mon         
Strs        , Mon         , Mon         , Mon^Af      , Mon^Af      , Mon^Af      , Mon         , Mon         , Mon         , Mon         , Mon         , Mon         , Mon         , Lh          , Lh          , Lh          , Lh          , Lh          , Mon         , Lh          , Mon         , Mon^Af      , Mon^Af      , Mon^Af      , Mon         , Mon^Af      , Mon         , Mon         , Mon         , Mon         , Mon         , Mon         , Mon         , Mon         , Mon         , Mon         
