border_size=1
usage=map

Xos         , Xos         , Xos         , Xos         , Xos         , Xos         , Xos         , Xos         , Xos         , Xos         , Xos         , Xos         , Xos         , Xos         , Xos         , Xos         , Xos         , Xos         , Xos         , Xos         , Xos         , Xos         , Xos         , Xos         , Xos         , Xos         , Xos         , Xos         , Xos         , Xos         , Xos         , Xos         
Xos         , Rr          , Rr^StrB     , Rr^StrB     , Rr^StrB     , Rr          , Rr          , Rr          , Rr          , Rr          , Rr          , Rr          , Rr          , Rr          , Rr          , Rr          , Rr          , Rr          , Rr          , Rr          , Rr          , Rr          , Rr          , Rr          , Mon^Fty     , Rr          , Rr          , Rr          , Rr          , Rr          , Rr          , Xos         
Xos         , Rr          , Rr^StrB     , 2 Rr^StrK   , Rr^StrB     , Rr          , Rr          , Rr          , Rr          , Rr          , Mon^Xxx     , Rr          , Rr          , Rr          , Rr          , Rr          , Rr          , Rr          , Rr          , Rr          , Rr          , Rr          , Rr          , Rr          , Rr          , Rr          , Rr          , Rr          , Mon^Fre     , Rr          , Rr          , Xos         
Xos         , Rr          , Rr          , Rr^StrB     , Rr          , Rr          , Rr          , Rr          , Rr          , Rr          , Rr          , Rr          , Rr          , Rr          , Rr          , Rr          , Rr          , Rr          , Rr          , Rr          , Rr          , Rr          , Rr          , Rr          , Rr          , Rr          , Rr          , Rr          , Rr          , Rr          , Rr          , Xos         
Xos         , Rr          , Rr          , Rr          , Rr          , Rr          , Xos         , Rr          , Rr          , Rr          , Rr          , Rr          , Rr          , Rr          , Rr          , Mon^Fty     , Rr          , Rr          , Rr          , Rr          , Rr          , Mon^Fre     , Rr          , Rr          , Rr          , Rr          , Rr          , Rr          , Rr          , Rr          , Rr          , Xos         
Xos         , Xos         , Xos         , Mon^Fre     , Xos         , Xos         , Rr          , Xos         , Xos         , Rr          , Rr          , Rr          , Rr          , Rr          , Rr          , Rr          , Rr          , Rr          , Rr          , Rr          , Rr          , Rr          , Rr          , Rr          , Rr          , Rr          , Rr          , Mon^Xxx     , Rr          , Rr          , Rr          , Xos         
Xos         , Rr          , Rr          , Xos         , Rr          , Rr          , Rr          , Rr          , Rr          , Xos         , Xos         , Rr          , Rr          , Rr          , Xos         , Rr          , Rr          , Rr          , Rr          , Rr          , Rr          , Rr          , Rr          , Rr          , Rr          , Rr          , Rr          , Rr          , Xos         , Rr          , Xos         , Xos         
Xos         , Rr          , Mon^Fre     , Rr          , Rr          , Rr          , Mon^Rea     , Rr          , Rr          , Rr          , Rr          , Xos         , Xos         , Xos         , Ql          , Rr          , Rr          , Rr          , Rr          , Rr          , Rr          , Rr          , Mon^Fty     , Rr          , Rr          , Rr          , Xos         , Xos         , Rr          , Xos         , Rr          , Xos         
Xos         , Rr          , Rr          , Rr          , Rr          , Rr          , Rr          , Rr          , Rr          , Rr          , Mon^Fre     , Rr          , Rr          , Rr          , Ql^Bs/      , Rr          , Rr          , Rr          , Rr          , Xos         , Xos         , Rr          , Rr          , Rr          , Rr          , Rr          , Rr          , Rr          , Rr          , Rr          , Mon^Fty     , Xos         
Xos         , Rr          , Rr          , Rr          , Rr          , Mon^Fre     , Rr          , Rr          , Rr          , Rr          , Rr          , Rr          , Xos         , Rr          , Ql          , Rr          , Mon^Fre     , Rr          , Rr          , Xos         , Rr          , Xos         , Rr          , Rr          , Xos         , Rr          , Mon^Xxx     , Rr          , Rr          , Rr          , Rr          , Xos         
Xos         , Rr          , Rr          , Rr          , Rr          , Rr          , Rr          , Rr          , Rr          , Rr          , Rr          , Xos         , Rr          , Xos         , Xos         , Rr          , Rr          , Rr          , Xos         , Xos         , Rr          , Rr          , Rr          , Rr          , Xos         , Rr          , Rr^StrB     , Rr^StrB     , Rr^StrB     , Rr          , Rr          , Xos         
Xos         , Rr          , Rr          , Mon^Fty     , Rr          , Rr          , Rr          , Rr          , Rr          , Mon^Rea     , Rr          , Xos         , Mon^Xxx     , Rr          , Rr          , Xos         , Xos         , Xos         , Rr          , Rr          , Rr          , Rr          , Rr          , Rr          , Xos         , Rr          , Rr^StrB     , 1 Rr^StrK   , Rr^StrB     , Rr          , Rr          , Rr          
Xos         , Rr          , Rr          , Rr          , Rr          , Rr          , Rr          , Rr          , Rr          , Rr          , Rr          , Xos         , Rr          , Rr          , Rr          , Rr          , Rr          , Rr          , Rr          , Rr          , Rr          , Rr          , Mon^Xxx     , Rr          , Xos         , Rr          , Rr          , Rr^StrB     , Rr          , Rr          , Rr          , Rr          
Xos         , Xos         , Xos         , Xos         , Xos         , Xos         , Xos         , Xos         , Xos         , Xos         , Xos         , Xos         , Xos         , Xos         , Xos         , Xos         , Xos         , Xos         , Xos         , Xos         , Xos         , Xos         , Xos         , Xos         , Xos         , Xos         , Xos         , Rr          , Rr          , Rr          , Rr          , Rr          
