border_size=1
usage=map

Strs        , Strs        , Strs        , Strs        , Strs        , Strs        , Strs        , Strs        , Strs        , Strs        , Strs        , Strs        , Strs        , Strs        , Strs        , Strs        , Strs        , Strs        , Strs        , Strs        , Strs        , Strs        
Strs        , Strs        , Strs        , Strs        , Strs        , Strs        , Strs        , Strs        , Strs        , Strs        , Strs        , Strs        , Strs        , Strs        , Strs        , Strs        , Strs        , Strs        , Strs        , Strs        , Strs        , Strs        
Strs        , Strs        , Strs        , Strs        , Strs        , Strs        , Strs        , Strs        , Strs        , Strs        , Strs        , Strs        , Strs        , Strs        , Strs        , Strs        , Strs        , Strs        , Strs        , Strs        , Strs        , Strs        
Strs        , Strs        , Strs        , Strs        , Strs        , Strs        , Strs        , Strs        , Strs        , Strs        , Strs        , Strs        , Strs        , Strs        , Strs        , Strs        , Strs        , Strs        , Strs        , Strs        , Strs        , Strs        
Strs        , Strs        , Strs        , Strs        , Strs        , 2 Strs      , Strs        , Strs        , Strs        , Strs        , Strs        , Strs        , Strs        , Strs        , Strs        , Strs        , 1 Strs      , Strs        , Strs        , Strs        , Strs        , Strs        
Strs        , Strs        , Strs        , Strs        , Strs        , Strs        , Strs        , Strs        , Strs        , Strs        , Strs        , Strs        , Strs        , Strs        , Strs        , Strs        , Strs        , Strs        , Strs        , Strs        , Strs        , Strs        
Strs        , Strs        , Strs        , Strs        , Strs        , Strs        , Strs        , Strs        , Strs        , Strs        , Strs        , Strs        , Strs        , Strs        , Strs        , Strs        , Strs        , Strs        , Strs        , Strs        , Strs        , Strs        
Strs        , Strs        , Strs        , Strs        , Strs        , Strs        , Strs        , Strs        , Strs        , Strs        , Strs        , Strs        , Strs        , Strs        , Strs        , Strs        , Strs        , Strs        , Strs        , Strs        , Strs        , Strs        
Strs        , Strs        , Strs        , Strs        , Strs        , Strs        , Strs        , Strs        , Strs        , Strs        , Strs        , Strs        , Strs        , Strs        , Strs        , Strs        , Strs        , Strs        , Strs        , Strs        , Strs        , Strs        
Strs        , Strs        , Strs        , Strs        , Strs        , Strs        , Strs        , Strs        , Strs        , Strs        , Strs        , Strs        , Strs        , Strs        , Strs        , Strs        , Strs        , Strs        , Strs        , Strs        , Strs        , Strs        
