border_size=1
usage=map

Mon^Min     , Lp          , Lp          , Lp          , Lh          , Lh          , Mon         , Mon         , Mon         , Mon         , Mon         , Mon         , Mon         , Mon         , Mon         , Mon         , Mon         , Mon         , Mon         
Lp          , Lp          , Lp          , Lp          , Lh          , Mon         , Mon^StrB    , Mon^StrB    , Mon^StrB    , Mon         , Mon         , Mon^Xxx     , Mon^StrB    , Mon^StrB    , Mon^StrB    , Mon         , Mon         , Mon         , Re          
Lp          , Lp          , Lp          , Lh          , Mon         , Mon^StrB    , Mon^StrB    , 2 Mon^StrK  , Mon^StrB    , Mon^StrB    , Mon         , Mon^StrB    , Mon^StrB    , 3 Mon^StrK  , Mon^StrB    , Mon^StrB    , Re          , Re          , Lh          
Lp          , Lp          , Lh          , Lh          , Mon         , Mon^Rea     , Mon         , Mon^StrB    , Mon^Af      , Mon^Af      , Mon         , Mon         , Mon         , Mon^StrB    , Re          , Re          , Mon^Rea     , Lh          , Lp          
Lp          , Lh          , Mon^Fty     , Mon         , Re          , Mon         , Mon         , Mon         , Mon         , Mon^Af      , Mon         , Mon         , Mon         , Mon         , Re          , Re          , Mon^Af      , Lh          , Lp          
Lh          , Lh          , Re          , Re          , Re          , Re          , Mon         , Mon         , Mon         , Mon         , Mon         , Mon         , Mon         , Mon         , Re          , Re          , Mon^Af      , Lh          , Lp          
Re^Af       , Re          , Re^Af       , Re          , Re          , Re          , Lh          , Mon         , Mon         , Mon         , Mon         , Mon         , Mon         , Mon         , Re          , Re          , Re          , Lh          , Lp          
Re^Af       , Re          , Re          , Re          , Lh          , Lh          , Mon^Xxx     , Lh          , Lh          , Mon         , Mon         , Mon         , Mon         , Mon         , Mon         , Re          , Re          , Lh          , Lp          
Re^Af       , Re          , Re          , Re          , Lh          , Lh          , Lp          , Lp          , Lh          , Re          , Mon         , Mon         , Mon         , Mon         , Mon         , Mon         , Mon         , Lh          , Lh          
Re          , Re^Af       , Re^Af       , Re          , Lh          , Lp          , Lp          , Lp          , Lh          , Re          , Mon         , Mon         , Mon         , Mon         , Mon         , Mon         , Mon         , Mon         , Re          
Re          , Re          , Re          , Re          , Lh          , Lh          , Lh          , Lh          , Lh          , Re          , Mon         , Mon         , Mon         , Mon         , Mon         , Mon^Fty     , Mon         , Mon         , Re          
Lh          , Re          , Re          , Mon         , Mon         , Mon         , Mon         , Mon         , Mon         , Mon         , Mon         , Mon         , Mon         , Mon         , Mon         , Mon         , Mon         , Mon         , Re          
Mon^Xxx     , Re          , Mon         , Mon         , Mon         , Mon         , Mon         , Mon         , Mon         , Mon         , Mon         , Mon         , Mon         , Mon         , Mon         , Mon         , Mon         , Re          , Re          
Lp          , Lh          , Re          , Mon         , Mon         , Mon         , Mon         , Mon         , Mon         , Mon         , Mon         , Mon^Af      , Mon^Af      , Mon         , Mon         , Mon         , Mon         , Re          , Re          
Lp          , Lh          , Re          , Mon         , Mon         , Mon^Rea     , Mon         , Mon         , Mon         , Mon         , Mon         , Mon^Af      , Mon         , Mon         , Mon         , Mon         , Mon         , Re          , Re          
Lp          , Lh          , Lh          , Re          , Mon         , Mon         , Mon         , Mon         , Mon         , Mon         , Mon         , Mon         , Mon         , Mon         , Mon         , Mon         , Lh          , Mon^Rea     , Lp          
Mon^Min     , Lh          , Lh          , Re          , Mon         , Mon         , Mon         , Mon         , Mon         , Mon         , Mon         , Mon         , Re          , Re          , Lh          , Lh          , Lp          , Lp          , Lp          
Lh          , Lp          , Mon^Fty     , Mon         , Mon         , Mon         , Mon         , Mon         , Mon         , Mon         , Mon         , Mon         , Re          , Lh          , Lh          , Lp          , Lp          , Lp          , Lp          
Lp          , Lp          , Lh          , Mon         , Mon         , Mon         , Mon^StrB    , Mon^StrB    , Mon^StrB    , Mon         , Mon         , Mon         , Re          , Lh          , Mon^Fty     , Lp          , Lp          , Mon^Min     , Lp          
Lp          , Lh          , Mon^Af      , Mon         , Mon         , Mon         , Mon^StrB    , 1 Mon^StrK  , Mon^StrB    , Mon         , Mon         , Mon         , Mon^Af      , Re          , Re          , Lh          , Lp          , Lp          , Lp          
Lh          , Lh          , Mon^Af      , Mon^Af      , Mon         , Mon         , Mon         , Mon         , Mon         , Mon         , Mon         , Mon^Af      , Mon^Af      , Mon^Af      , Lh          , Lh          , Lp          , Lp          , Lp          
