border_size=1
usage=map

Mon         , Mon         , Mon         , Mon         , Mon         , Mon         , Lh          , Lp          , Lp          , Lp          , Lp          , Lp          , Lp          , Lp          , Lp          , Lp          , Lp          , Lp          , Lp          , Lp          , Lp          , Lp          , Lp          , Lp          , Lp          , Lh          , Lh          , Mon         , Mon         , Mon         , Mon         , Mon         , Mon         , Mon         , Mon         , Mon         , Mon         , Mon         , Mon         , Mon         , Mon         , Mon         , Mon         , Mon         , Mon         , Mon         
Mon         , Mon         , Mon^StrB    , Mon         , Mon         , Mon         , Mon^Fty     , Lh          , Lh          , Lh          , Lh          , Lh          , Lh          , Lh          , Lh          , Lh          , Lh          , Lh          , Lh          , Mon^Min     , Lh          , Lh          , Lh          , Lh          , Lp          , Lp          , Lh          , Lh          , Mon         , Mon         , Mon         , Mon         , Mon         , Mon         , Mon^StrB    , Mon         , Mon         , Mon         , Mon         , Mon         , Mon         , Mon         , Mon         , Mon         , Mon         , Mon         
Mon         , Mon^StrB    , 1 Mon^StrK  , Mon^StrB    , Mon         , Mon         , Mon         , Mon         , Mon^Af      , Mon^Af      , Mon^Af      , Lh          , Mon         , Lh          , Lh          , Lh          , Mon         , Lh          , Lh          , Lh          , Lh          , Lh          , Mon^Fty     , Lh          , Lh          , Lh          , Lh          , Lh          , Mon         , Mon         , Mon^Rea     , Mon         , Mon         , Mon^StrB    , 3 Mon^StrK  , Mon^StrB    , Mon         , Mon         , Mon         , Mon         , Mon         , Mon         , Lh          , Mon         , Mon         , Mon         
Mon         , Mon^StrB    , Mon^StrB    , Mon^StrB    , Mon         , Mon         , Mon         , Mon         , Mon         , Mon^Af      , Mon         , Mon         , Mon         , Mon         , Mon         , Mon         , Mon         , Mon         , Mon         , Mon         , Mon         , Mon         , Mon         , Mon         , Mon         , Lh          , Mon         , Mon         , Mon         , Mon         , Mon         , Mon         , Mon         , Mon^StrB    , Mon^StrB    , Mon^StrB    , Mon         , Mon         , Lh          , Mon         , Lh          , Lh          , Lh          , Lh          , Lh          , Lh          
Mon         , Mon         , Lh          , Mon         , Mon         , Mon         , Mon         , Mon         , Mon         , Mon         , Mon         , Mon         , Mon         , Mon         , Mon         , Mon         , Mon         , Mon         , Mon         , Mon         , Mon         , Mon         , Mon         , Mon         , Mon         , Mon         , Mon         , Mon         , Mon         , Mon         , Mon         , Mon         , Mon         , Mon         , Mon         , Mon         , Lh          , Lh          , Lh          , Lh          , Lh          , Lh          , Lp          , Lh          , Lh          , Lh          
Lh          , Lh          , Mon^Min     , Lh          , Lh          , Mon         , Mon         , Mon         , Mon         , Mon         , Mon         , Mon         , Mon^Af      , Mon         , Mon         , Mon         , Mon         , Mon^Rea     , Mon         , Mon         , Mon         , Mon         , Mon         , Mon         , Mon         , Mon         , Mon         , Mon         , Mon^Af      , Mon^Af      , Mon         , Mon         , Mon         , Mon         , Mon         , Mon         , Lh          , Lh          , Lh          , Lh          , Lp          , Mon^Min     , Lp          , Lp          , Lh          , Lh          
Lp          , Lp          , Lh          , Lp          , Lp          , Lh          , Mon         , Mon         , Mon         , Mon         , Mon         , Mon         , Mon         , Mon^Af      , Mon         , Mon         , Mon         , Mon         , Mon         , Mon         , Mon         , Mon         , Mon         , Mon         , Mon^StrB    , Mon^StrB    , Mon^StrB    , Mon         , Mon         , Mon^Af      , Mon^Af      , Mon         , Mon         , Mon         , Mon         , Mon         , Lh          , Lh          , Lp          , Lp          , Lp          , Lp          , Lp          , Lp          , Lp          , Lh          
Lh          , Lh          , Mon         , Lh          , Lh          , Lh          , Mon         , Mon         , Mon         , Mon         , Mon         , Mon         , Mon         , Mon^Af      , Mon         , Mon         , Mon         , Mon         , Mon         , Mon         , Mon         , Mon         , Mon         , Mon         , Mon^StrB    , 2 Mon^StrK  , Mon^StrB    , Mon         , Mon         , Mon         , Mon         , Mon         , Mon         , Mon         , Mon         , Mon         , Lh          , Lh          , Lh          , Lp          , Lp          , Lp          , Mon^Min     , Lp          , Lp          , Lh          
Mon         , Mon         , Mon         , Mon         , Mon         , Mon         , Mon         , Mon         , Mon^Af      , Mon         , Mon         , Mon         , Mon         , Mon         , Mon         , Mon         , Mon         , Mon         , Mon         , Mon         , Mon         , Mon         , Mon         , Mon         , Mon         , Mon^StrB    , Mon         , Mon         , Mon         , Mon         , Mon         , Mon         , Mon         , Mon         , Mon         , Mon         , Mon^Rea     , Lh          , Lh          , Lp          , Lp          , Lp          , Lp          , Lp          , Lh          , Lh          
Mon         , Mon         , Mon         , Mon         , Mon         , Mon         , Mon^Fty     , Mon         , Mon^Af      , Mon         , Mon         , Mon         , Mon         , Mon         , Mon         , Mon         , Mon         , Mon         , Mon^Fre     , Mon         , Mon         , Mon         , Mon         , Mon         , Mon         , Mon         , Mon         , Mon         , Mon         , Mon         , Mon         , Mon         , Mon         , Mon         , Mon         , Mon         , Mon         , Lh          , Lh          , Lh          , Lh          , Lh          , Lh          , Lh          , Lh          , Lh          
Mon         , Mon         , Mon         , Mon         , Mon         , Mon         , Mon         , Mon         , Mon         , Mon         , Mon         , Mon         , Mon         , Mon         , Mon         , Mon         , Mon^Af      , Mon^Af      , Mon         , Mon         , Mon         , Mon         , Mon         , Mon         , Mon         , Mon         , Mon         , Mon         , Mon         , Mon         , Mon         , Mon         , Mon         , Mon         , Mon         , Mon         , Mon         , Lh          , Lh          , Lh          , Lh          , Lh          , Mon         , Lh          , Mon         , Mon         
Mon         , Mon         , Lh          , Mon         , Lh          , Mon         , Mon         , Mon         , Mon         , Mon         , Mon         , Mon         , Mon         , Mon         , Mon         , Mon^Af      , Mon         , Mon         , Mon         , Mon         , Mon         , Mon         , Mon         , Mon         , Mon         , Mon         , Mon         , Mon         , Mon         , Mon         , Mon         , Mon         , Mon         , Mon         , Mon         , Mon         , Mon         , Mon         , Mon         , Mon         , Mon         , Mon         , Mon         , Mon         , Mon         , Mon         
Lh          , Lh          , Lh          , Lh          , Lh          , Lh          , Lh          , Lh          , Lh          , Lh          , Lh          , Mon         , Mon         , Mon         , Mon         , Mon         , Mon         , Mon         , Mon         , Mon         , Mon         , Mon         , Mon         , Mon         , Mon         , Mon         , Mon         , Mon         , Mon^Fty     , Mon         , Mon         , Mon         , Mon         , Mon         , Mon         , Mon         , Mon         , Mon         , Mon         , Mon         , Mon         , Mon         , Mon         , Mon         , Xu          , Xu          
Lp          , Lp          , Mon^Min     , Lh          , Lh          , Lh          , Lh          , Lh          , Lh          , Lh          , Lh          , Lh          , Lh          , Lh          , Lh          , Lh          , Lh          , Lh          , Lh          , Mon         , Lh          , Mon         , Lh          , Lh          , Lh          , Lh          , Lh          , Lh          , Lh          , Mon         , Mon         , Mon         , Mon         , Mon         , Mon         , Mon         , Mon         , Mon         , Mon         , Mon         , Mon         , Mon         , Xu          , Uu          , Uu          , Uu          
Lp          , Lp          , Lh          , Lp          , Lp          , Lp          , Lp          , Lp          , Lp          , Lp          , Lp          , Lp          , Lp          , Lp          , Lp          , Lp          , Lp          , Lp          , Lp          , Lh          , Lp          , Lp          , Lp          , Lp          , Lp          , Lp          , Lp          , Lp          , Lp          , Lh          , Mon         , Mon         , Mon         , Mon         , Mon         , Mon         , Mon         , Mon         , Mon         , Mon         , Xu          , Xu          , Xu          , Uu          , Uu          , Uu          
