border_size=1
usage=map

Rr          , Rr          , Rr          , Rr          , Rr          , Rr          , Rr          , Rr          , Rr          , Rr          , Rr          , Rr          , Rr          , Rr          , Rr          , Rr          , Rr          , Rr          , Lh          , Lh          , Lh          , Lp          , Lp          , Lp          , Lp          , Lp          
Rr          , Rr          , Rr^StrB     , Rr          , Rr          , Rr          , Rr^StrB     , Rr^StrB     , Rr^StrB     , Rr          , Rr          , Rr          , Rr          , Rr          , Rr          , Rr          , Rr          , Rr          , Lh          , Lh          , Lh          , Lh          , Mon^Min     , Lp          , Lp          , Lp          
Rr          , Rr^StrB     , 2 Rr^StrK   , Rr^StrB     , Rr          , Rr          , Rr^StrB     , 3 Rr^StrK   , Rr^StrB     , Rr          , Rr          , Rr          , Rr          , Rr          , Rr          , Rr          , Rr          , Rr          , Rr          , Lh          , Lh          , Lh          , Lh          , Lp          , Lp          , Lp          
Rr          , Rr^StrB     , Rr^StrB     , Rr^StrB     , Rr          , Rr          , Rr^StrB     , Rr^StrB     , Rr^StrB     , Rr          , Rr          , Rr          , Rr          , Rr          , Rr          , Rr          , Mon^Fty     , Rr          , Rr          , Rr          , Lh          , Lh          , Lh          , Lp          , Lp          , Lp          
Rr          , Rr^StrB     , Rr^StrB     , Rr^StrB     , Rr          , Rr          , Rr          , Rr^StrB     , Rr          , Rr          , Mon^Fty     , Rr          , Rr          , Rr          , Rr          , Rr          , Rr          , Rr          , Rr          , Rr          , Rr          , Lh          , Lh          , Lp          , Lp          , Lp          
Rr          , Rr          , Rr          , Rr          , Rr          , Rr          , Rr          , Rr          , Rr          , Rr          , Rr          , Rr          , Rr          , Rr          , Rr          , Rr          , Rr          , Rr          , Rr          , Rr          , Rr          , Rr          , Lh          , Lp          , Lp          , Lp          
Rr          , Rr          , Rr          , Rr          , Mon^Fre     , Rr          , Rr          , Rr          , Rr          , Rr          , Rr          , Rr          , Rr          , Rr          , Rr          , Rr          , Rr          , Rr          , Rr          , Rr          , Rr          , Rr          , Lh          , Lp          , Lp          , Lp          
Rr          , Rr          , Rr          , Rr          , Rr          , Rr          , Rr          , Rr          , Rr          , Rr          , Rr          , Rr          , Rr          , Rr          , Rr          , Rr          , Rr          , Rr          , Rr          , Rr          , Rr          , Rr          , Lh          , Lp          , Lp          , Lp          
Rr          , Rr          , Rr          , Rr          , Rr          , Rr          , Rr          , Rr          , Rr          , Rr          , Rr          , Rr          , Mon^Xxx     , Rr          , Rr          , Rr          , Rr          , Rr          , Rr          , Mon^Fty     , Rr          , Rr          , Lh          , Lp          , Lp          , Lp          
Rr          , Rr          , Rr          , Rr          , Rr          , Rr          , Mon^Fty     , Rr          , Rr          , Rr          , Rr          , Rr          , Rr          , Rr          , Rr          , Rr          , Rr          , Rr          , Rr          , Rr          , Lh          , Lh          , Lp          , Lp          , Lp          , Lp          
Rr          , Mon^Xxx     , Rr          , Rr          , Rr          , Rr          , Rr          , Rr          , Rr          , Rr          , Rr          , Rr          , Rr          , Rr          , Rr          , Rr          , Rr          , Rr          , Rr          , Lh          , Lh          , Mon^Min     , Lp          , Lp          , Lp          , Lp          
Rr          , Rr          , Rr          , Rr          , Rr          , Rr          , Rr          , Rr          , Rr          , Rr          , Rr          , Rr          , Rr          , Rr          , Rr          , Rr          , Rr          , Rr          , Ce          , Lh          , Lh          , Lh          , Lp          , Lp          , Lp          , Lp          
Rr          , Rr          , Lh          , Rr          , Lh          , Rr          , Rr          , Rr          , Rr          , Rr          , Rr          , Rr          , Rr          , Rr          , Rr          , Rr          , Ce          , Rr          , Mon         , Mon         , Mon         , Lh          , Lh          , Lp          , Lh          , Lh          
Lh          , Lh          , Lh          , Lh          , Lh          , Lh          , Lh          , Rr          , Rr          , Mon^Fty     , Rr          , Rr          , Rr          , Rr          , Ce          , Rr          , Rr          , Mon         , Mon         , Mon         , Mon         , Mon         , Mon         , Lh          , Lh          , Lh          
Lh          , Lh          , Lh          , Lh          , Lh          , Lh          , Lh          , Lh          , Lh          , Rr          , Lp          , Rr          , Ce          , Rr          , Mon         , Rr          , Rr          , Rr          , Rr          , Mon         , Mon         , Mon         , Mon         , Mon         , Mon         , Mon         
Lh          , Lh          , Lp          , Mon^Min     , Lp          , Lh          , Lh          , Lh          , Lh          , Lh          , Lh          , Lh          , Lh          , Mon         , Mon         , Mon         , Mon         , Rr          , Rr          , Rr          , Rr          , Mon         , Mon         , Mon         , Mon         , Mon         
Lp          , Lp          , Lp          , Lp          , Lp          , Lp          , Lp          , Lh          , Lh          , Lh          , Lh          , Lh          , Lh          , Lh          , Lh          , Mon         , Mon         , Mon         , Mon         , Rr          , Rr          , Rr          , Mon         , Mon         , Mon         , Mon         
Lp          , Lp          , Lp          , Lp          , Lp          , Lp          , Lp          , Lp          , Lp          , Mon^Min     , Lp          , Lh          , Lh          , Lh          , Lh          , Lh          , Lh          , Mon         , Mon         , Mon         , Rr          , Rr          , Mon         , Mon         , Mon         , Mon         
Lp          , Lp          , Lp          , Lp          , Lp          , Lp          , Lp          , Lp          , Lp          , Lp          , Lp          , Lp          , Lp          , Lh          , Lh          , Lh          , Lh          , Mon         , Mon         , Mon         , Rr          , Rr          , Mon         , Mon         , Mon         , Mon         
Lp          , Lp          , Lp          , Lp          , Lp          , Lp          , Lp          , Lp          , Lp          , Lp          , Lp          , Lp          , Lp          , Lp          , Lh          , Lh          , Lh          , Mon         , Mon         , Mon         , Rr          , Rr          , Mon         , Mon         , Mon         , Mon         
Lp          , Lp          , Lp          , Lp          , Lp          , Lp          , Lp          , Lp          , Lp          , Lp          , Lp          , Lp          , Lp          , Lp          , Lh          , Lh          , Lh          , Mon         , Mon         , Mon         , Rr          , Rr          , Mon         , Mon         , Mon         , Mon         
Lp          , Lp          , Lp          , Lp          , Lp          , Lp          , Lp          , Lp          , Lp          , Lp          , Lp          , Lp          , Lp          , Lp          , Lh          , Lh          , Mon         , Mon         , Mon         , Mon         , Rr          , Rr          , Mon         , Mon         , Mon         , Mon         
Lp          , Lp          , Lp          , Lp          , Lp          , Lp          , Lp          , Lp          , Lp          , Lp          , Lp          , Lp          , Lp          , Lh          , Lh          , Lh          , Mon         , Mon         , Mon         , Mon         , Rr          , Rr          , Mon         , Mon         , Mon         , Mon         
Lp          , Lp          , Lp          , Lp          , Lp          , Lp          , Lp          , Lp          , Lp          , Lp          , Lp          , Lp          , Lp          , Lh          , Lh          , Mon^Fre     , Mon         , Mon         , Mon         , Mon         , Rr          , Rr          , Mon         , Mon         , Mon         , Mon         
Lp          , Lp          , Lp          , Lp          , Lp          , Lp          , Lp          , Lp          , Lp          , Lp          , Lp          , Lp          , Lp          , Lh          , Lh          , Lh          , Mon         , Mon         , Mon         , Mon         , Rr          , Rr          , Mon         , Mon         , Mon         , Mon         
Lp          , Lp          , Lp          , Lp          , Lp          , Lp          , Lp          , Lp          , Lp          , Lp          , Lp          , Lp          , Lp          , Lh          , Lh          , Lh          , Mon         , Mon         , Mon         , Mon         , Rr          , Rr          , Mon         , Mon         , Mon         , Mon         
Lp          , Lp          , Lp          , Lp          , Lp          , Lp          , Lp          , Lp          , Lp          , Lp          , Lp          , Lp          , Lp          , Lh          , Lh          , Ce          , Mon         , Mon         , Mon         , Mon         , Rr          , Rr          , Mon         , Mon         , Mon         , Mon         
Lp          , Lp          , Lp          , Lp          , Lp          , Lp          , Lp          , Lp          , Lp          , Lp          , Lp          , Lp          , Lp          , Lh          , Lh          , Lh          , Mon         , Mon         , Mon         , Mon         , Rr          , Rr          , Mon         , Mon         , Mon         , Mon         
Lp          , Lp          , Lp          , Lp          , Lp          , Lp          , Lp          , Lp          , Lp          , Lp          , Lp          , Lp          , Lp          , Lh          , Lh          , Lh          , Mon         , Mon         , Mon         , Mon         , Rr          , Rr          , Mon         , Mon         , Mon         , Mon         
Lp          , Lp          , Lp          , Lp          , Lp          , Lp          , Lp          , Lp          , Lp          , Lp          , Lp          , Lp          , Lh          , Lh          , Lh          , Lh          , Mon         , Mon         , Mon         , Mon         , Rr          , Rr          , Mon         , Mon         , Mon         , Mon         
Lp          , Lp          , Lp          , Lp          , Lp          , Lp          , Lp          , Lp          , Lp          , Lp          , Lp          , Lp          , Lh          , Lh          , Lh          , Lh          , Mon         , Mon         , Mon         , Mon         , Rr          , Rr          , Mon         , Mon         , Mon         , Mon         
Lp          , Lp          , Lp          , Lp          , Lp          , Lp          , Lp          , Lp          , Lp          , Lp          , Lp          , Mon^Min     , Lh          , Lh          , Lh          , Mon         , Mon         , Mon         , Mon         , Mon         , Rr          , Rr          , Mon         , Mon         , Mon         , Mon         
Lp          , Lp          , Lp          , Lp          , Lp          , Lp          , Lp          , Lp          , Lp          , Lp          , Lp          , Lp          , Lh          , Lh          , Lh          , Mon         , Mon         , Mon         , Mon         , Mon         , Rr          , Rr          , Mon         , Mon         , Mon         , Mon         
Lp          , Lp          , Lp          , Lp          , Lp          , Lp          , Lp          , Lp          , Lp          , Lp          , Lp          , Lp          , Lh          , Lh          , Lh          , Mon         , Mon         , Mon         , Mon         , Mon         , Rr          , Rr          , Rr          , Mon         , Mon^Fty     , Mon         
Lp          , Lp          , Lp          , Lp          , Lp          , Lp          , Lp          , Lp          , Lp          , Lp          , Lp          , Lp          , Lh          , Lh          , Lh          , Mon         , Mon         , Mon         , Mon         , Mon         , Mon^StrB    , Rr          , Rr          , Rr          , Rr          , Mon         
Lp          , Lp          , Lp          , Lp          , Lp          , Lp          , Lp          , Lp          , Lp          , Lp          , Lp          , Lp          , Lh          , Lh          , Lh          , Mon         , Mon         , Mon         , Mon^StrB    , Mon^StrB    , 1 Mon^StrK  , Mon^StrB    , Mon^StrB    , Rr          , Rr          , Rr          
Lp          , Lp          , Lp          , Lp          , Lp          , Lp          , Lp          , Lp          , Lp          , Lp          , Lp          , Lp          , Mon^Min     , Lh          , Lh          , Mon         , Mon         , Mon         , Mon         , Mon^StrB    , Mon^StrB    , Mon^StrB    , Mon         , Mon         , Mon         , Rr          
Lp          , Lp          , Lp          , Lp          , Lp          , Lp          , Lp          , Lp          , Lp          , Lp          , Lp          , Lp          , Lh          , Lh          , Lh          , Mon         , Mon         , Mon         , Mon         , Mon         , Mon         , Mon         , Mon         , Mon         , Mon         , Mon         
