border_size=1
usage=map

Mon         , Mon         , Mon         , Mon         , Mon         , Mon         , Mon         , Mon         , Mon         , Mon         , Mon         , Mon         , Mon         , Mon         , Mon         , Mon         , Mon         , Mon         , Mon         , Lh          , Lh          , Lh          , Lh          , Lh          , Lh          , Lh          , Lh          , Lh          , Lp          , Lh          , Lh          
Mon         , Mon^StrB    , Mon^StrB    , Mon^StrB    , Mon         , Mon         , Mon         , Mon         , Lh          , Mon         , Mon         , Mon         , Mon         , Mon         , 2 Mon^StrK  , Mon         , Mon^Fty     , Mon         , Lh          , Lh          , Lp          , Lp          , Lp          , Lp          , Lp          , Lp          , Mon^Min     , Lp          , Lp          , Lp          , Lh          
Mon         , Mon^StrB    , 3 Mon^StrK  , Mon^StrB    , Mon         , Lh          , Lh          , Lh          , Lp          , Lh          , Mon         , Mon         , Mon         , Mon^StrB    , Mon^StrB    , Mon^StrB    , Mon         , Mon         , Mon         , Lh          , Lh          , Lp          , Lh          , Lp          , Lp          , Lp          , Lh          , Lp          , Lh          , Lp          , Lh          
Mon         , Mon^StrB    , Mon^StrB    , Mon^StrB    , Lh          , Lh          , Lp          , Lp          , Lp          , Lh          , Lh          , Mon         , Mon         , Mon         , Mon         , Mon         , Mon         , Mon         , Mon         , Mon         , Mon         , Lh          , Lh          , Lh          , Lh          , Lp          , Lp          , Lp          , Lp          , Lp          , Lh          
Mon         , Mon^StrB    , Mon^StrB    , Mon^StrB    , Mon         , Lh          , Lp          , Mon^Min     , Lp          , Lp          , Lh          , Mon         , Mon         , Mon         , Mon         , Mon         , Mon         , Mon         , Mon         , Mon         , Mon         , Mon         , Mon         , Lh          , Lh          , Lh          , Lh          , Lp          , Lp          , Lp          , Lp          
Mon         , Mon^StrB    , Mon         , Mon^StrB    , Mon         , Lh          , Lh          , Lp          , Lh          , Lp          , Lp          , Lh          , Lh          , Mon         , Mon         , Mon         , Mon         , Mon         , Mon^Af      , Mon         , Mon         , Mon         , Mon         , Mon         , Mon         , Mon         , Mon         , Lh          , Lh          , Lp          , Lh          
Mon         , Mon         , Mon         , Mon         , Mon         , Mon         , Mon         , Mon         , Mon         , Lh          , Lh          , Lp          , Lp          , Mon         , Mon         , Mon         , Mon         , Mon         , Mon^Af      , Mon^Af      , Mon         , Mon         , Mon         , Mon         , Mon         , Mon         , Mon         , Mon         , Mon^StrB    , Lh          , Mon         
Mon         , Mon         , Mon         , Mon^Fty     , Mon         , Mon         , Mon         , Mon         , Mon         , Mon         , Mon         , Lh          , Lh          , Lh          , Mon         , Mon         , Mon         , Mon         , Mon         , Mon         , Mon         , Mon         , Mon         , Mon         , Mon         , Mon^Gen     , Mon         , Mon^StrB    , 4 Mon^StrK  , Mon^StrB    , Mon         
Lh          , Mon         , Mon         , Mon         , Mon         , Mon         , Mon         , Mon         , Mon         , Mon^Gen     , Mon         , Mon         , Mon         , Lh          , Mon         , Mon         , Mon^StrB    , Mon         , Mon^StrB    , Mon         , Mon         , Mon         , Mon         , Mon         , Mon         , Mon         , Mon         , Mon^StrB    , Mon^StrB    , Mon^StrB    , Mon         
Lp          , Lh          , Lh          , Mon         , Lh          , Mon^Af      , Mon^Af      , Mon         , Mon         , Mon         , Mon         , Mon         , Mon         , Mon         , Mon         , Mon^StrB    , Mon^StrB    , Mon^StrB    , Mon^StrB    , Mon^StrB    , Mon         , Mon         , Mon         , Mon         , Mon         , Mon         , Mon         , Mon^StrB    , Mon^StrB    , Mon^StrB    , Mon         
Lp          , Lp          , Lp          , Lh          , Lp          , Lh          , Lh          , Mon         , Mon         , Mon         , Mon         , Mon         , Mon         , Mon         , Mon         , Mon^StrB    , Mon^StrB    , 1 Mon^StrK  , Mon^StrB    , Mon^StrB    , Mon         , Mon         , Mon         , Mon         , Mon         , Mon         , Mon         , Mon^StrB    , Lh          , Mon^StrB    , Mon         
Lp          , Lp          , Mon^Min     , Lp          , Lp          , Lp          , Lp          , Lh          , Lh          , Mon         , Mon         , Mon         , Mon         , Mon         , Mon         , Mon^StrB    , Mon^StrB    , Mon^StrB    , Mon^StrB    , Mon^StrB    , Mon         , Mon         , Mon         , Mon         , Mon         , Mon         , Mon         , Lh          , Lp          , Lh          , Mon         
Lp          , Lp          , Lp          , Lp          , Lp          , Lp          , Lh          , Lh          , Lh          , Lh          , Mon         , Mon         , Mon         , Mon         , Mon         , Mon         , Mon         , Mon         , Mon         , Mon^Fty     , Mon         , Mon         , Mon         , Mon         , Mon         , Mon         , Lh          , Lh          , Lp          , Lh          , Lh          
Lp          , Lp          , Lp          , Lp          , Lp          , Lp          , Lh          , Lh          , Lp          , Lh          , Lh          , Mon         , Mon         , Mon         , Mon         , Mon^Af      , Mon^Af      , Mon         , Mon         , Mon         , Mon         , Mon         , Mon         , Mon         , Mon         , Mon         , Lh          , Lp          , Lp          , Lp          , Lh          
Lh          , Lh          , Lh          , Lh          , Lp          , Lp          , Lp          , Lp          , Lh          , Lh          , Lh          , Mon         , Mon         , Mon         , Mon         , Mon^Af      , Mon         , Mon         , Mon         , Mon         , Mon         , Mon         , Mon         , Mon         , Mon         , Mon         , Mon         , Lh          , Lh          , Lp          , Lh          
Lp          , Mon^Min     , Lp          , Lp          , Lp          , Lp          , Lh          , Lp          , Lh          , Lh          , Mon         , Mon         , Mon         , Mon         , Mon         , Mon         , Mon         , Mon         , Lh          , Mon         , Mon         , Mon         , Mon         , Mon         , Mon^StrB    , Mon^StrB    , Mon^StrB    , Mon         , Mon         , Lh          , Mon         
Lh          , Lp          , Lh          , Lh          , Lh          , Lh          , Mon^StrB    , Lh          , Mon         , Lh          , Mon         , Mon         , Mon^Fty     , Mon         , Mon         , Mon         , Mon         , Lh          , Lp          , Lh          , Lh          , Mon         , Mon         , Mon         , Mon^StrB    , 5 Mon^StrK  , Mon^StrB    , Mon^Fty     , Mon         , Mon         , Mon         
Mon         , Lh          , Mon         , Mon         , Mon         , Mon^StrB    , 6 Mon^StrK  , Mon^StrB    , Mon         , Mon         , Mon         , Mon         , Mon         , Mon         , Mon         , Mon         , Lh          , Lh          , Lp          , Lp          , Lh          , Mon         , Mon         , Mon         , Mon^StrB    , Mon^StrB    , Mon^StrB    , Mon         , Mon         , Mon         , Mon         
Mon         , Mon         , Mon         , Mon         , Mon         , Mon         , Mon         , Mon         , Mon         , Mon         , Mon         , Mon         , Mon         , Mon         , Mon         , Lh          , Lh          , Lp          , Lp          , Lp          , Lp          , Lh          , Mon         , Mon         , Mon         , Mon         , Mon         , Mon         , Mon         , Mon         , Mon         
